person_id,birth_year,start_year,working_start_age,retirement_age,death_age,retirement_year,death_year,initial_salary,salary_growth_rate,total_earning_points,current_pension_value,annual_pension,years_in_retirement,total_pension_payout,total_contributions,balance
0,1930,1954,24,61,69,1991,1999,33390.730008183076,0.03484250789732435,96.9127520725319,14.926133389213764,1446.5326645504138,8,11572.26131640331,454711.19835410465,443138.93703770137
1,1927,1954,27,60,65,1987,1992,11742.508365045984,0.04830880728874676,36.695012451262535,13.261676191778331,486.6373729819178,5,2433.186864909589,169271.3357083309,166838.1488434213
2,1933,1954,21,65,66,1998,1999,29526.654188465585,0.007820578951355014,60.753832701958444,18.357261367239552,1115.2739859713968,1,1115.2739859713968,287105.8186944132,285990.54470844177
3,1929,1954,25,63,60,1992,1989,15454.74901621302,0.01417022549267169,28.538556316004414,15.373917390890178,0.0,0,0.0,129093.3495998919,129093.3495998919
4,1927,1954,27,63,70,1990,1997,10691.872751242472,0.03123873301291946,27.805766453446957,14.491391640013362,402.9442515276452,7,2820.6097606935164,129005.03485617568,126184.42509548216
5,1927,1954,27,60,70,1987,1997,25427.03315240835,0.03462072844310212,62.18858644801887,13.261676191778331,824.7248962980404,10,8247.248962980404,283395.02325814165,275147.77429516125
6,1934,1954,20,62,61,1996,1995,30409.22615763339,0.027524962598477153,87.81034337890705,17.30347946765911,0.0,0,0.0,420084.33370489534,420084.33370489534
7,1935,1954,19,61,67,1996,2002,38968.96099223678,0.04541986740582306,176.27275066593526,17.30347946765911,3050.131921855804,6,18300.791531134826,871271.7803484072,852970.9888172724
8,1928,1954,26,67,63,1995,1991,16926.81476866447,0.017051273301300587,34.93643963438127,16.79949462879525,0.0,0,0.0,160514.67235512394,160514.67235512394
9,1930,1954,24,65,61,1995,1991,37279.61206236346,0.017938999080000847,78.21164837364952,16.79949462879525,0.0,0,0.0,359728.8305536064,359728.8305536064
10,1929,1954,25,61,60,1990,1989,22754.67623473734,0.015397083143409443,42.91080216289332,14.491391640013362,0.0,0,0.0,194366.3210598864,194366.3210598864
11,1933,1954,21,63,60,1996,1993,33253.98470083343,0.05197494707820945,152.15507333735434,17.30347946765911,0.0,0,0.0,739560.5028328403,739560.5028328403
12,1933,1954,21,65,65,1998,1998,25625.02780077471,0.05305860121746746,154.29509766330793,18.357261367239552,2832.435435489096,0,0.0,783811.4509669194,783811.4509669194
13,1932,1954,22,59,63,1991,1995,27602.534969915447,0.0532627653632069,117.22249085874104,14.926133389213764,1749.67853477346,4,6998.71413909384,561110.9004237502,554112.1862846563
14,1929,1955,26,58,67,1987,1996,39606.608098015524,0.04361223846483287,106.9920020581106,13.261676191778331,1418.8932864047435,9,12770.039577642692,493186.2791215739,480416.2395439312
15,1930,1955,25,65,69,1995,1999,15965.272122664155,0.0405670976374325,58.52700044388693,16.79949462879525,983.2240295965757,4,3932.896118386303,285984.8806845909,282051.9845662046
16,1935,1955,20,58,69,1993,2004,12221.339552022711,0.022923286427213634,28.767700373834167,15.835134912616882,455.5404165454031,11,5010.944581999434,135470.02985782738,130459.08527582795
17,1929,1955,26,64,67,1993,1996,28698.943804826737,0.02154490124263246,65.77224932740384,15.835134912616882,1041.5124416057147,3,3124.537324817144,309190.30185565184,306065.7645308347
18,1931,1955,24,64,66,1995,1997,29977.6706985249,0.034564889385386356,96.26287792923443,16.79949462879525,1617.1677007245469,2,3234.3354014490938,466721.43834809936,463487.10294665024
19,1932,1955,23,60,59,1992,1991,21487.806242613697,0.05358560476945519,86.19318042710131,15.373917390890178,0.0,0,0.0,413808.50331795646,413808.50331795646
20,1935,1955,20,58,63,1993,1998,26838.31592708489,0.04354835899772805,96.21705057656408,15.835134912616882,1523.609976773974,5,7618.04988386987,464498.3204112946,456880.2705274247
21,1931,1955,24,66,68,1997,1999,10762.573802322855,0.010394571349665222,22.08323149331503,17.822583851688883,393.5802450058638,2,787.1604900117276,104749.05164880994,103961.89115879821
22,1931,1955,24,58,62,1989,1993,26898.26715929151,0.039775804321306375,74.62291854055125,14.069312271857633,1049.8931435844104,4,4199.5725743376415,347988.89533386304,343789.3227595254
23,1933,1955,22,64,65,1997,1998,22311.48769106889,0.04277755692715243,93.68359308701561,17.822583851688883,1669.6836933208367,1,1669.6836933208367,466464.56925296166,464794.8855596408
24,1934,1955,21,64,69,1998,2003,30843.547991191135,0.049023391950762885,157.84342481522194,18.357261367239552,2897.5730044332545,5,14487.865022166272,799273.4268246023,784785.561802436
25,1928,1955,27,66,63,1994,1991,36143.81770563153,0.045183603844955726,122.14881575892393,16.31018895999539,0.0,0,0.0,581509.2118380966,581509.2118380966
26,1934,1955,21,67,65,2001,1999,36882.7389977048,0.020900173748593195,99.72529099335772,20.05947514203957,0.0,0,0.0,487313.70029705804,487313.70029705804
27,1937,1955,18,58,67,1995,2004,29430.70361624087,0.005026018849765791,51.98825276432318,16.79949462879525,873.3763730746971,9,7860.3873576722735,241856.66061634483,233996.27325867256
28,1930,1956,26,60,65,1990,1995,14939.675594288252,0.031704470968772096,35.40886214542166,14.491391640013362,513.123688876549,5,2565.6184443827447,165641.47213904376,163075.85369466103
29,1934,1956,22,58,61,1992,1995,18082.370013955646,0.01720627611238871,35.515317915996945,15.373917390890178,546.0095637517389,3,1638.028691255217,165778.31205148785,164140.28336023263
30,1928,1956,28,63,66,1991,1994,31090.568766855336,0.0231814801189647,65.72986273573196,14.926133389213764,981.0926988482463,3,2943.278096544739,306884.9285481269,303941.65045158216
31,1938,1956,18,67,62,2005,2000,17406.281885158038,0.039815213641989415,73.00357892218449,22.577115996341544,0.0,0,0.0,371834.3965963819,371834.3965963819
32,1936,1956,20,58,63,1994,1999,18545.21483132403,0.00684434736772664,31.97664600081189,16.31018895999539,521.5451385801229,5,2607.7256929006144,149123.4168545116,146515.69116161097
33,1938,1956,18,59,60,1997,1998,22331.11039954694,0.006652536645027419,41.14291241139205,17.822583851688883,733.273006354726,1,733.273006354726,195044.92858496684,194311.65557861212
34,1938,1956,18,58,61,1996,1999,30421.163546643005,0.03154672916585682,90.51896990349748,17.30347946765911,1566.2931371588215,3,4698.879411476464,441921.08456548705,437222.20515401056
35,1929,1956,27,63,65,1992,1994,30164.066422176358,0.04308098076643588,96.67454553986416,15.373917390890178,1486.266476931722,2,2972.532953863444,464287.78475156234,461315.2517976989
36,1928,1956,28,58,64,1986,1992,21033.493981577594,0.036615291529678975,45.41517886936652,12.875413778425564,584.7392197643032,6,3508.4353185858195,207413.90517541138,203905.46985682557
37,1933,1956,23,63,69,1996,2002,34492.95619658152,0.04491725624922756,137.9647099418728,17.30347946765911,2387.2695257407404,6,14323.617154444442,685311.1215313593,670987.5043769148
38,1930,1956,26,63,61,1993,1991,27726.788295647253,0.03887821809211412,78.25840900500876,15.835134912616882,0.0,0,0.0,371394.4868347522,371394.4868347522
39,1936,1956,20,67,61,2003,1997,34285.03138419146,0.02243329936458647,86.87010815764127,21.281097178189782,0.0,0,0.0,421659.67756996094,421659.67756996094
40,1932,1956,24,61,67,1993,1999,30728.132143073977,0.02433676731502687,71.10462578523223,15.835134912616882,1125.9513422202895,6,6755.708053321737,336852.612335723,330096.90428240126
41,1937,1956,19,65,59,2002,1996,30270.70351117842,0.04176080596203861,112.73735629100145,20.66125939630076,0.0,0,0.0,557783.6236246425,557783.6236246425
42,1938,1957,19,64,68,2002,2006,17738.248831454668,0.03799920230170895,73.07968602783089,20.66125939630076,1509.9183496212304,4,6039.673398484922,378240.65928222844,372200.9858837435
43,1930,1957,27,66,62,1996,1992,25889.517350680195,0.017092614545022585,48.648187622963384,17.30347946765911,0.0,0,0.0,228127.15805685226,228127.15805685226
44,1935,1957,22,62,69,1997,2004,15661.21325024138,0.018943567629609095,35.452990616509126,17.822583851688883,631.863898055873,7,4423.047286391111,171976.31766272354,167553.27037633242
45,1937,1957,20,60,62,1997,1999,36612.592727953524,0.043993777292881196,141.84323092218742,17.822583851688883,2528.012876905155,2,5056.02575381031,711507.2226748976,706451.1969210873
46,1932,1957,25,61,69,1993,2001,38069.04982662843,0.04426703255569718,123.57716989783947,15.835134912616882,1956.8611574516658,8,15654.889259613326,600755.8041679434,585100.9149083301
47,1932,1957,25,61,61,1993,1993,21168.48299685229,0.05200667212288892,80.41159747596932,15.835134912616882,1273.3284945710172,0,0.0,393979.61843895394,393979.61843895394
48,1931,1957,26,59,60,1990,1991,24568.412607586797,0.027421207149312368,51.36466581670119,14.491391640013362,744.3454888082238,1,744.3454888082238,240266.76182713258,239522.41633832434
49,1931,1957,26,61,59,1992,1990,10542.260908465625,0.029694685759171734,22.91240724434573,15.373917390890178,0.0,0,0.0,107405.24986090766,107405.24986090766
50,1936,1957,21,65,66,2001,2002,35476.702314825336,0.03788064461501717,140.2749879737002,20.05947514203957,2813.842634308339,1,2813.842634308339,720189.7436843812,717375.9010500729
51,1939,1957,18,60,64,1999,2003,17956.071030451763,0.01719948216895418,41.475893437630326,18.907979208256734,784.225330762586,4,3136.901323050344,203253.2695790882,200116.36825603785
52,1934,1957,23,63,61,1997,1995,36761.396655313394,0.03655693129986314,111.33267399027396,17.822583851688883,0.0,0,0.0,544899.3769936684,544899.3769936684
53,1938,1957,19,62,59,2000,1997,27307.116538790775,0.029625884690943197,77.13556242127586,19.47521858450444,0.0,0,0.0,379740.5665472738,379740.5665472738
54,1935,1957,22,60,62,1995,1997,10729.478992943616,0.03727361479535839,32.98087878226689,16.79949462879525,554.06209595564,2,1108.12419191128,161556.68931233088,160448.5651204196
55,1939,1957,18,62,64,2001,2003,21104.761007663332,0.005772830826443372,40.27987610639314,20.05947514203957,807.9931734806269,2,1615.9863469612537,195998.82953672454,194382.84318976328
56,1933,1958,25,58,63,1991,1996,27168.774075125148,0.054016579185802285,90.31286999122254,14.926133389213764,1348.0219442517084,5,6740.109721258542,437358.1178522223,430618.0081309638
57,1937,1958,21,62,65,1999,2002,18054.245706704703,0.029263993713815786,51.825407104622734,18.907979208256734,979.9137199936474,3,2939.741159980942,259666.3891874983,256726.64802751737
58,1939,1958,19,66,68,2005,2007,38084.643224823434,0.03980148983374865,175.58076492022528,22.577115996341544,3964.1072963303022,2,7928.2145926606045,936404.8464163622,928476.6318237016
59,1933,1958,25,65,60,1998,1993,28450.216800975093,0.05450269250521316,106.60628136242498,18.357261367239552,0.0,0,0.0,524993.7751578059,524993.7751578059
60,1939,1958,19,67,60,2006,1999,19676.522927158017,0.04743348974623372,85.4395373818239,23.25442947623179,0.0,0,0.0,438737.3447820642,438737.3447820642
61,1932,1958,26,63,65,1995,1997,18807.7553279348,0.04546805777392568,64.87101621358495,16.79949462879525,1089.80028844461,2,2179.60057688922,321757.58954688546,319577.9889699962
62,1938,1958,20,59,67,1997,2005,28345.411325970417,0.009079709020012018,51.04159113882215,17.822583851688883,909.693037995278,8,7277.544303962224,245408.23588045538,238130.69157649315
63,1934,1958,24,66,62,2000,1996,33948.85536900326,0.03749819653888826,103.70117196001405,19.47521858450444,0.0,0,0.0,513703.95679055416,513703.95679055416
64,1938,1958,20,64,70,2002,2008,27365.94686522676,0.02692370615090435,82.23706983588517,20.66125939630076,1699.1214318709242,6,10194.728591225545,419455.8846805506,409261.1560893251
65,1935,1958,23,60,67,1995,2002,14651.248501832326,0.054092044415526556,60.62279700994348,16.79949462879525,1018.4323527510903,7,7129.026469257632,303422.2300672797,296293.20359802205
66,1935,1958,23,67,68,2002,2003,10915.007498171482,0.006867409437460721,21.07577957726567,20.66125939630076,435.452148825144,1,435.452148825144,103880.15866331574,103444.7065144906
67,1935,1958,23,63,69,1998,2004,13811.815379556543,0.03111216300274022,39.834869794227075,18.357261367239552,731.2591163425824,6,4387.554698055495,198663.2090775707,194275.6543795152
68,1936,1958,22,62,65,1998,2001,12560.423949813041,0.007584086058430385,22.526766977767522,18.357261367239552,413.5297491697794,3,1240.5892475093383,108695.87690351061,107455.28765600127
69,1937,1958,21,60,65,1997,2002,14150.59277253404,0.011637271112148491,26.730999268871873,17.822583851688883,476.4154759089032,5,2382.077379544516,128973.23880747311,126591.1614279286
70,1940,1959,19,67,61,2007,2001,33855.58584306111,0.018541612563103712,78.70833417315488,23.952062360518745,0.0,0,0.0,395068.49332860415,395068.49332860415
71,1932,1959,27,64,68,1996,2000,10760.522302463725,0.053132420733896256,43.14501206526126,17.30347946765911,746.5588304031528,4,2986.235321612611,218105.1627666016,215118.92744498898
72,1935,1959,24,66,70,2001,2005,22268.588332428095,0.013664716003542288,46.75330270498324,20.05947514203957,937.8467134188627,4,3751.3868536754508,232889.24487584532,229137.85802216988
73,1941,1959,18,59,64,2000,2005,31437.87768100187,0.038009868835886564,108.48960067940351,19.47521858450444,2112.8586873769846,5,10564.293436884924,556277.9086748289,545713.6152379441
74,1937,1959,22,58,65,1995,2002,29713.339855005004,0.026783644933894554,67.26878860933161,16.79949462879525,1130.0816529280296,7,7910.571570496208,328017.97522841307,320107.4036579169
75,1935,1959,24,60,70,1995,2005,26981.116314822288,0.01293232238212455,47.55261169348017,16.79949462879525,798.8598447298065,10,7988.5984472980645,228241.7513840011,220253.15293670303
76,1936,1959,23,66,70,2002,2006,11380.079260652583,0.0070364401159485074,21.355929764810206,20.66125939630076,441.24040451992397,4,1764.9616180796959,105856.72907695865,104091.76745887895
77,1938,1959,21,62,70,2000,2008,10514.833054952507,0.04316822115019555,40.859270122250386,19.47521858450444,795.7432168341377,8,6365.9457346731015,210953.66783558475,204587.72210091166
78,1937,1959,22,64,62,2001,1999,15196.056097300456,0.026692582461898654,39.47196712335878,20.05947514203957,0.0,0,0.0,197828.19534085155,197828.19534085155
79,1935,1959,24,67,68,2002,2003,38474.37194774158,0.04933401936490238,189.9476540053594,20.66125939630076,3924.5577511235174,1,3924.5577511235174,1005291.54467735,1001366.9869262264
80,1938,1959,21,67,68,2005,2006,38003.08924238449,0.030051994195762963,129.86115236106758,22.577115996341544,2931.8903002744055,1,2931.8903002744055,683077.3763365027,680145.4860362284
81,1934,1959,25,62,62,1996,1996,28475.534931697413,0.05219458022803786,111.91447072754515,17.30347946765911,1936.509746368014,0,0.0,565199.1368167035,565199.1368167035
82,1940,1959,19,58,70,1998,2010,27573.2674382039,0.05201151207124788,119.54602065754925,18.357261367239552,2194.5375466240503,12,26334.450559488603,613756.6233568098,587422.1727973212
83,1934,1959,25,59,61,1993,1995,29298.646553270595,0.027912644524575835,62.8291869230229,15.835134912616882,994.9086513760919,2,1989.8173027521839,302582.18225212855,300592.3649493764
84,1940,1960,20,62,70,2002,2010,21583.079134023228,0.053059528191195714,110.27464669061209,20.66125939630076,2278.4130801101555,8,18227.304640881244,587908.9759310768,569681.6712901955
85,1933,1960,27,59,61,1992,1994,28547.616530136787,0.021827710744436325,50.69822552754465,15.373917390890178,779.4303311251911,2,1558.8606622503821,242205.40286388324,240646.54220163287
86,1933,1960,27,65,68,1998,2001,30448.410069183694,0.022031228473212004,66.69185383450674,18.357261367239552,1224.2797919057775,3,3672.8393757173326,331343.51561207854,327670.6762363612
87,1940,1960,20,66,65,2006,2005,13544.944828649688,0.03983685826820753,56.59182884755537,23.25442947623179,0.0,0,0.0,303566.6129083295,303566.6129083295
88,1932,1960,28,65,62,1997,1994,22538.380951467363,0.05337902757601237,76.52507641113596,17.822583851688883,0.0,0,0.0,381661.58932373766,381661.58932373766
89,1939,1960,21,67,63,2006,2002,32518.44254922575,0.0453417369633632,137.48942519847972,23.25442947623179,0.0,0,0.0,725602.6243923235,725602.6243923235
90,1942,1960,18,60,62,2002,2004,21160.542573783496,0.04382064803709984,86.24965645455009,20.66125939630076,1782.0265248492856,2,3564.053049698571,454244.0770460576,450680.023996359
91,1935,1960,25,64,63,1999,1998,17157.905793710204,0.03899223899501229,52.89897642220601,18.907979208256734,0.0,0,0.0,268313.7397313903,268313.7397313903
92,1936,1960,24,66,61,2002,1997,13093.716065077979,0.050127645333978336,48.71779416410239,20.66125939630076,0.0,0,0.0,248209.97920953497,248209.97920953497
93,1939,1960,21,66,64,2005,2003,18929.055235279324,0.00999924435809317,37.33026061713748,22.577115996341544,0.0,0,0.0,187999.9611404624,187999.9611404624
94,1939,1960,21,66,61,2005,2000,12738.600303584008,0.020965681879520744,29.073344202475383,22.577115996341544,0.0,0,0.0,146149.77841527452,146149.77841527452
95,1939,1960,21,60,68,1999,2007,28955.116365093978,0.027422276098915992,73.0011136351864,18.907979208256734,1380.3035387936916,8,11042.428310349533,367688.47880379896,356646.05049344944
96,1940,1960,20,66,62,2006,2002,30175.553682311154,0.042618726471884,119.50507587185346,23.25442947623179,0.0,0,0.0,628350.9996562104,628350.9996562104
97,1936,1960,24,66,65,2002,2001,12736.18309146071,0.029721015235129076,36.12776309153486,20.66125939630076,0.0,0,0.0,185139.10437210297,185139.10437210297
98,1937,1961,24,67,63,2004,2000,32111.066703730266,0.03229578850824945,88.57779406647641,21.919530093535478,0.0,0,0.0,453891.7256075202,453891.7256075202
99,1933,1961,28,59,70,1992,2003,30640.900305251173,0.04684819371186869,77.84899251647484,15.373917390890178,1196.8439799123119,11,13165.28377903543,381287.7860877311,368122.50230869564
100,1943,1961,18,63,65,2006,2008,22782.744251408236,0.01612882087855153,53.188211086341155,23.25442947623179,1236.8615036742501,2,2473.7230073485002,277038.74621693994,274565.02320959145
101,1935,1961,26,59,69,1994,2004,31187.266814694885,0.009067439032094988,46.235955257456546,16.31018895999539,754.1171669950086,10,7541.171669950086,221988.3865325876,214447.2148626375
102,1939,1961,22,63,61,2002,2000,27439.16251680347,0.048156926099450194,106.7169065891158,20.66125939630076,0.0,0,0.0,557535.2185979367,557535.2185979367
103,1938,1961,23,61,59,1999,1997,38417.45732151576,0.054300053191143546,146.46342304508312,18.907979208256734,0.0,0,0.0,751389.8339236777,751389.8339236777
104,1940,1961,21,61,64,2001,2004,31245.435867495995,0.02908334939820577,83.51281324106735,20.05947514203957,1675.2232012509835,3,5025.669603752951,429210.9767080283,424185.3071042753
105,1938,1961,23,64,69,2002,2007,17461.724632908637,0.021512626450954926,41.08496078175163,20.66125939630076,848.8670319986142,5,4244.335159993071,210351.0525712129,206106.71741121984
106,1941,1961,20,59,70,2000,2011,27144.190756150318,0.042048693045533415,92.24331771855523,19.47521858450444,1796.4587755287546,11,19761.0465308163,478437.076086228,458676.0295554117
107,1936,1961,25,66,65,2002,2001,32381.346377962698,0.034168438254857984,96.53907915076921,20.66125939630076,0.0,0,0.0,499552.69141175144,499552.69141175144
108,1935,1961,26,58,67,1993,2002,36057.97384568381,0.016179791925972634,57.90915551002858,15.835134912616882,916.9992901770139,9,8252.993611593125,278269.90680013935,270016.9131885462
109,1938,1961,23,67,70,2005,2008,39337.02006262813,0.03280025193212923,131.51898473436208,22.577115996341544,2969.3193740687652,3,8907.958122206295,699834.8414635961,690926.8833413898
110,1939,1961,22,63,63,2002,2002,39788.943883579006,0.008689828236769944,72.20162707428777,20.66125939630076,1491.7765458168317,0,0.0,362648.1870738193,362648.1870738193
111,1941,1961,20,60,62,2001,2003,12263.036412693078,0.013310771595462647,23.76047123109615,20.05947514203957,476.6225820233196,2,953.2451640466392,119453.87057318074,118500.6254091341
112,1944,1962,18,58,63,2002,2007,30907.751675914446,0.024210091568961,73.77215359388947,20.66125939630076,1524.2256016270917,5,7621.128008135458,380767.7038926321,373146.5758844966
113,1938,1962,24,66,69,2004,2007,18428.89568776691,0.052520574203827934,90.8946432662268,21.919530093535478,1992.36786841523,3,5977.10360524569,494966.40784012043,488989.3042348747
114,1937,1962,25,63,70,2000,2007,13202.68197807653,0.02178300323984816,28.1566301027327,19.47521858450444,548.356525853757,7,3838.4956809762994,142939.60551973662,139101.1098387603
115,1935,1962,27,61,68,1996,2003,21648.051519696164,0.016469737285247484,36.908908507524146,17.30347946765911,638.6525405336527,7,4470.567783735569,181565.017307344,177094.44952360843
116,1940,1962,22,66,62,2006,2002,39586.32233438808,0.03990808570098726,132.45814941567158,23.25442947623179,0.0,0,0.0,698163.6293181141,698163.6293181141
117,1944,1962,18,66,59,2010,2003,22336.201626165588,0.035139094101164926,69.90381521727167,26.17306524702257,0.0,0,0.0,368937.0165031529,368937.0165031529
118,1942,1962,20,63,60,2005,2002,22499.171732154377,0.03405813105904131,66.18851078828428,22.577115996341544,0.0,0,0.0,346217.07395075547,346217.07395075547
119,1936,1962,26,59,68,1995,2004,37981.85450062039,0.04830319447502042,108.73476354912812,16.79949462879525,1826.6890762068995,9,16440.201685862095,547459.4269961191,531019.2253102569
120,1940,1962,22,64,66,2004,2006,21293.90100634149,0.04552766653909165,88.47976542994755,21.919530093535478,1939.4348810106953,2,3878.8697620213907,477402.72644311364,473523.85668109223
121,1944,1962,18,62,68,2006,2012,21426.725698930648,0.05349571989073016,119.57492942908051,23.25442947623179,2780.646763533946,6,16683.880581203674,663391.4907232109,646707.6101420072
122,1934,1962,28,58,59,1992,1993,24060.79479384911,0.025740975116883263,41.11026691054724,15.373917390890178,632.0258474001992,1,632.0258474001992,198814.66939248703,198182.64354508684
123,1944,1962,18,62,65,2006,2009,35941.671287651596,0.045645050456503876,163.55809043219526,23.25442947623179,3803.450079222626,3,11410.350237667877,897361.6961423524,885951.3459046845
124,1940,1962,22,63,61,2003,2001,26662.951168078824,0.043449370759025524,92.41241056795972,21.281097178189782,0.0,0,0.0,485404.7249687754,485404.7249687754
125,1940,1962,22,67,68,2007,2008,21335.516478273596,0.017054241616481593,50.30676065371041,23.952062360518745,1204.9506683333625,1,1204.9506683333625,265352.14371445164,264147.19304611825
126,1937,1963,26,58,61,1995,1998,18241.953910777265,0.015361382450402822,28.297687183050524,16.79949462879525,475.3868438389855,3,1426.1605315169566,138882.5919792461,137456.43144772915
127,1945,1963,18,58,66,2003,2011,28543.847213736874,0.022908135901642028,65.60080550392487,21.281097178189782,1396.0571168965523,8,11168.456935172419,341698.69227747683,330530.2353423044
128,1938,1963,25,64,68,2002,2006,24944.955599376786,0.028810534839450713,62.62009374015509,20.66125939630076,1293.810000186014,4,5175.240000744056,326512.6979423603,321337.45794161625
129,1943,1963,20,59,70,2002,2013,34491.57205639187,0.05339868827199115,147.72163223122806,20.66125939630076,3052.114961974346,11,33573.264581717805,793578.6418521568,760005.377270439
130,1935,1963,28,66,59,2001,1994,14020.456853519223,0.006439133815666949,18.417638330252,20.05947514203957,0.0,0,0.0,89158.95347066835,89158.95347066835
131,1941,1963,22,62,60,2003,2001,34151.34002558085,0.05015755293383131,129.3550858087783,21.281097178189782,0.0,0,0.0,686661.8273103132,686661.8273103132
132,1944,1963,19,63,60,2007,2004,27697.530605638993,0.02461220225498662,68.08102543147095,23.952062360518745,0.0,0,0.0,357893.61744806636,357893.61744806636
133,1935,1963,28,60,60,1995,1995,20447.66401069901,0.030699474457990542,40.62367993513607,16.79949462879525,682.4572928722158,0,0.0,202138.42028343037,202138.42028343037
134,1938,1963,25,64,68,2002,2006,35870.911262402355,0.052476031182882105,150.4392581883729,20.66125939630076,3108.2645368170356,4,12433.058147268142,807337.9700017702,794904.911854502
135,1942,1963,21,67,66,2009,2008,35262.74245056129,0.04344588706576987,156.4952275378205,25.410742958274337,0.0,0,0.0,872390.8503946314,872390.8503946314
136,1942,1963,21,65,63,2007,2005,39400.97725856431,0.02963090469964348,111.71857900398508,23.952062360518745,0.0,0,0.0,595813.445403685,595813.445403685
137,1935,1963,28,60,67,1995,2002,23803.574769507162,0.03423830529745769,50.17609131839829,16.79949462879525,842.9329765973722,7,5900.530836181605,250441.069954796,244540.5391186144
138,1935,1963,28,63,66,1998,2001,15402.018170478956,0.039825073311353945,40.999258663845325,18.357261367239552,752.6341071552692,3,2257.9023214658077,210257.56978378116,207999.66746231535
139,1937,1963,26,60,61,1997,1998,25457.081645926326,0.05365551746350521,84.09199104236569,17.822583851688883,1498.736561608033,1,1498.736561608033,433499.93155343836,432001.1949918303
140,1937,1964,27,60,61,1997,1998,34653.719105333475,0.022254131391119338,61.52559258788603,17.822583851688883,1096.5450329224468,1,1096.5450329224468,309182.4781733613,308085.9331404388
141,1937,1964,27,63,63,2000,2000,26461.45927622226,0.03172117518662615,62.25495093063753,19.47521858450444,1212.4287773417639,0,0.0,322394.1293180018,322394.1293180018
142,1937,1964,27,59,59,1996,1996,25102.518125645707,0.03951974143146826,57.25624591063422,17.30347946765911,990.7322755099001,0,0.0,290234.21925442334,290234.21925442334
143,1938,1964,26,67,67,2005,2005,24434.361821688795,0.03938923585480415,82.3860578265994,22.577115996341544,1860.0395840324368,0,0.0,447015.70756917924,447015.70756917924
144,1939,1964,25,58,68,1997,2007,36049.03321106761,0.009225850384034097,51.84681844569728,17.822583851688883,924.0442691917297,10,9240.442691917297,257272.59862986134,248032.15593794404
145,1944,1964,20,61,66,2005,2010,24535.68955573064,0.0359127385765148,76.44488435848629,22.577115996341544,1725.9050214884603,5,8629.525107442301,412823.5995957932,404194.0744883509
146,1940,1964,24,65,60,2005,2000,32424.128144012695,0.006834160144529896,48.71329027724654,22.577115996341544,0.0,0,0.0,245207.78392481673,245207.78392481673
147,1939,1964,25,60,65,1999,2004,30614.965162099932,0.04722203363168144,92.99413497047291,18.907979208256734,1758.3311705115223,5,8791.655852557611,485672.72044673614,476881.0645941785
148,1936,1964,28,59,68,1995,2004,20624.400123793763,0.024858191625204126,35.40836435609092,16.79949462879525,594.8426268145747,9,5353.583641331173,176050.02696084246,170696.44331951128
149,1938,1964,26,64,63,2002,2001,15468.516354278741,0.03319825460094182,38.95014667923367,20.66125939630076,0.0,0,0.0,203497.40058945466,203497.40058945466
150,1946,1964,18,64,64,2010,2010,19824.920565337437,0.010988106590962561,40.861357163310764,26.17306524702257,1069.4669671172257,0,0.0,219194.3451702545,219194.3451702545
151,1946,1964,18,61,67,2007,2013,30373.069574334688,0.044458561930366916,125.67366118196813,23.952062360518745,3010.1433697052043,6,18060.860218231224,697766.6410025689,679705.7807843377
152,1945,1964,19,61,64,2006,2009,27605.233540626374,0.042271973709216495,103.78238533354079,23.25442947623179,2413.4001606139364,3,7240.200481841809,569818.5767329151,562578.3762510733
153,1946,1964,18,60,68,2006,2014,18513.277173961735,0.023154114819931758,44.991488094331615,23.25442947623179,1046.2513869203567,8,8370.011095362854,240229.2018347924,231859.19073942953
154,1938,1965,27,59,69,1997,2007,20682.90177693539,0.054325762439648984,60.54160040819958,17.822583851688883,1079.0077497905788,10,10790.077497905788,314054.9540572341,303264.87655932835
155,1943,1965,22,66,59,2009,2002,10226.030894022242,0.016266639885626412,18.445968225158477,25.410742958274337,0.0,0,0.0,95496.1782383187,95496.1782383187
156,1942,1965,23,64,62,2006,2004,35524.52553508439,0.009394381227007195,59.60112916699815,23.25442947623179,0.0,0,0.0,309502.9601122038,309502.9601122038
157,1940,1965,25,64,67,2004,2007,12407.012369849266,0.031225569478512735,32.03506967533937,21.919530093535478,702.1936737971072,3,2106.5810213913214,171263.2629743188,169156.68195292747
158,1940,1965,25,62,62,2002,2002,39917.66604305183,0.04983051314870104,139.73602183326204,20.66125939630076,2887.1221941041736,0,0.0,751727.4326476577,751727.4326476577
159,1944,1965,21,61,64,2005,2008,39252.01488835427,0.029537438962939224,101.39446895235129,22.577115996341544,2289.1946869246863,3,6867.584060774059,544758.3051998169,537890.7211390429
160,1942,1965,23,60,67,2002,2009,31553.71812509661,0.03175183660224553,76.37743337187949,20.66125939630076,1578.0539629200805,7,11046.377740440563,402756.66866824677,391710.2909278062
161,1938,1965,27,60,70,1998,2008,16152.326804483773,0.05339970332521171,49.16581169440853,18.357261367239552,902.5496556067403,10,9025.496556067403,256911.9229367101,247886.4263806427
162,1944,1965,21,60,62,2004,2006,25228.31136053365,0.01712048662075401,49.03038342569084,21.919530093535478,1074.7229649970136,2,2149.445929994027,257299.42595984746,255149.98002985344
163,1947,1965,18,67,64,2014,2011,27437.14664267837,0.012718135763710116,58.14423025778736,29.45801552022873,0.0,0,0.0,316372.368413607,316372.368413607
164,1944,1965,21,60,59,2004,2003,21076.914445296883,0.027713398610954985,48.868755969916315,21.919530093535478,0.0,0,0.0,258271.26810833233,258271.26810833233
165,1943,1965,22,64,68,2007,2011,39698.80697169836,0.02111769224873615,91.31625564990134,23.952062360518745,2187.212649855509,4,8748.850599422036,491402.79247023084,482653.9418708088
166,1946,1965,19,61,59,2007,2005,14164.743203260612,0.0051355449707164835,22.474373272410524,23.952062360518745,0.0,0,0.0,116659.71459155824,116659.71459155824
167,1939,1965,26,65,64,2004,2003,22355.227424418055,0.022443413327149768,46.73079872060929,21.919530093535478,0.0,0,0.0,245352.45744356763,245352.45744356763
168,1948,1966,18,62,70,2010,2018,38950.80731999538,0.011214861174277238,75.49375879202867,26.17306524702257,1975.9030746067504,8,15807.224596854003,409225.2923110405,393418.0677141865
169,1941,1966,25,66,60,2007,2001,15436.991984969805,0.008324813368338875,22.65585342314058,23.952062360518745,0.0,0,0.0,116110.80338674721,116110.80338674721
170,1941,1966,25,63,70,2004,2011,35254.86330274816,0.011988618831314475,59.818629422134,21.919530093535478,1311.196247772513,7,9178.37373440759,313304.6686320223,304126.2948976147
171,1940,1966,26,62,70,2002,2010,14909.678285971135,0.013213289896549647,24.46014935252902,20.66125939630076,505.37749064486013,8,4043.019925158881,126788.39423579945,122745.37431064057
172,1944,1966,22,60,69,2004,2013,29012.756911605316,0.0503933065231258,106.89235890359998,21.919530093535478,2343.030277756455,9,21087.272499808092,586505.2067601075,565417.9342602994
173,1940,1966,26,67,67,2007,2007,30489.461902513973,0.027597430064951963,77.33176496252726,23.952062360518745,1852.2552568314316,0,0.0,421898.2004869554,421898.2004869554
174,1941,1966,25,60,64,2001,2005,26193.43185743899,0.026937233769416955,53.100454139721755,20.05947514203957,1065.1672398467608,4,4260.668959387043,277688.19778997457,273427.5288305875
175,1948,1966,18,66,59,2014,2007,36987.23719823705,0.024194561068660574,87.20018386072826,29.45801552022873,0.0,0,0.0,473407.89135187666,473407.89135187666
176,1944,1966,22,65,66,2009,2010,28727.139877419762,0.010844902035418203,53.99064678132918,25.410742958274337,1371.9424475113376,1,1371.9424475113376,290758.65428785054,289386.7118403392
177,1943,1966,23,60,65,2003,2008,31916.474104279045,0.03968588037016692,89.5567905116225,21.281097178189782,1905.866761844623,5,9529.333809223115,481765.22240371275,472235.8885944896
178,1945,1966,21,58,62,2003,2007,32243.827334171365,0.033657542462869436,80.15978254015643,21.281097178189782,1705.8881220196295,4,6823.552488078518,428289.37348967954,421465.821001601
179,1943,1966,23,66,59,2009,2002,31209.41383730377,0.043928596952537556,91.19040728653225,25.410742958274337,0.0,0,0.0,489009.6298952694,489009.6298952694
180,1948,1966,18,61,64,2009,2012,31421.922466708424,0.029699074356543134,89.32517115744449,25.410742958274337,2269.8189639856823,3,6809.4568919570465,495912.4321539473,489102.9752619903
181,1939,1966,27,58,64,1997,2003,34637.719140160385,0.010531586847760361,46.75756763941594,17.822583851688883,833.3406699545052,6,5000.044019727031,234734.7175767614,229734.67355703437
182,1946,1967,21,65,62,2011,2008,21918.61871681102,0.04486476828897768,81.18833243222781,26.958257204433245,0.0,0,0.0,458524.33126184094,458524.33126184094
183,1945,1967,22,61,70,2006,2015,33156.45941794735,0.0056101536159022265,50.7592011558842,23.25442947623179,1180.3762635493722,9,10623.38637194435,268021.46052317764,257398.07415123328
184,1947,1967,20,60,62,2007,2009,26281.733300427884,0.01758995294534764,51.899355614586405,23.952062360518745,1243.0966021513123,2,2486.1932043026245,280323.1629001286,277836.96969582594
185,1945,1967,22,61,69,2006,2014,38772.24383692083,0.02212621285892717,81.35692790898165,23.25442947623179,1891.9089424622873,8,15135.271539698299,439318.10851241706,424182.83697271877
186,1944,1967,23,65,65,2009,2009,23860.17410932398,0.052364166980590765,110.98638317411915,25.410742958274337,2820.246454706086,0,0.0,638227.9501808904,638227.9501808904
187,1940,1967,27,65,60,2005,2000,28343.627063039436,0.005905509191042026,37.460466366320695,22.577115996341544,0.0,0,0.0,191460.71179222385,191460.71179222385
188,1939,1967,28,61,62,2000,2001,33702.5391137226,0.006151130239381876,44.712559105440334,19.47521858450444,870.7868620510247,1,870.7868620510247,228581.52733501315,227710.74047296212
189,1940,1967,27,58,70,1998,2010,21233.06109161266,0.00844607696836094,27.492440510915774,18.357261367239552,504.68591608216576,12,6056.230992985989,139285.40600299882,133229.17501001284
190,1947,1967,20,65,67,2012,2014,37767.05538720329,0.027541968570206608,107.69617931794384,27.767004920566244,2990.400341047531,2,5980.800682095062,611133.6920603659,605152.8913782708
191,1945,1967,22,62,68,2007,2013,35166.94259337802,0.011233134060163342,61.284940575329884,23.952062360518745,1467.900718420987,6,8807.404310525922,328028.99857221474,319221.5942616888
192,1941,1967,26,58,64,1999,2005,25565.141713782163,0.03456377178724646,51.86572718205663,18.907979208256734,980.6760911794429,6,5884.056547076658,270530.4293172622,264646.3727701855
193,1945,1967,22,66,63,2011,2008,20055.917249377027,0.045142672429900575,74.77424277950013,26.958257204433245,0.0,0,0.0,422452.13392413437,422452.13392413437
194,1945,1967,22,67,67,2012,2012,13428.019001670633,0.025725229210181385,36.66215945411242,27.767004920566244,1017.9983619609238,0,0.0,207394.48168392282,207394.48168392282
195,1940,1967,27,63,60,2003,2000,23971.003669564394,0.02904184890445368,46.18039646277221,21.281097178189782,0.0,0,0.0,241356.47008253177,241356.47008253177
196,1940,1968,28,58,69,1998,2009,10985.40010730315,0.05063747314395644,26.083383678086477,18.357261367239552,478.81949152062356,11,5267.014406726859,137248.94752129875,131981.93311457188
197,1945,1968,23,65,67,2010,2012,24951.033182184394,0.0259462724752274,61.70165286850826,26.17306524702257,1614.921386376604,2,3229.842772753208,345652.6033789042,342422.760606151
198,1943,1968,25,58,59,2001,2002,33414.87122638263,0.018879358631470906,53.708033643034454,20.05947514203957,1077.3549657902745,1,1077.3549657902745,281058.23895514105,279980.88398935075
199,1941,1968,27,59,63,2000,2004,25455.21047220438,0.053777065784137816,71.39711646611707,19.47521858450444,1390.474449480951,4,5561.897797923804,382557.86594937637,376995.96815145254
200,1942,1968,26,58,62,2000,2004,22438.72371181071,0.009267483403932193,29.999281951308298,19.47521858450444,584.242573379908,4,2336.970293519632,154643.82759715305,152306.8573036334
201,1943,1968,25,58,65,2001,2008,27861.550519601315,0.008353823869421375,37.83528182785954,20.05947514203957,758.9558953180099,7,5312.69126722607,195975.17813695266,190662.4868697266
202,1944,1968,24,60,69,2004,2013,33993.460662228084,0.022469349952466654,64.39685508854365,21.919530093535478,1411.5488030423758,9,12703.939227381383,344826.4014633726,332122.4622359912
203,1950,1968,18,65,61,2015,2011,11971.259182850572,0.04377638083475053,46.61940838585779,30.34175598583559,0.0,0,0.0,270157.07427788456,270157.07427788456
204,1949,1968,19,59,64,2008,2013,23222.882408146845,0.0250381530437663,52.8082042931371,24.67062423133431,1302.8113644475206,5,6514.056822237603,291388.91061670094,284874.8537944633
205,1945,1968,23,60,62,2005,2007,15457.843914858135,0.048089281050675864,50.480436464019526,22.577115996341544,1139.702669594118,2,2279.405339188236,280111.0846078216,277831.67926863336
206,1944,1968,24,60,68,2004,2012,18122.340194306613,0.03719997716195079,45.35773749570409,21.919530093535478,994.2202920117684,8,7953.762336094147,246857.71925598852,238903.95691989438
207,1950,1968,18,64,65,2014,2015,14684.57792098571,0.040798611442369875,59.94456371791303,29.45801552022873,1765.847888355622,1,1765.847888355622,354359.1056164665,352593.2577281109
208,1943,1968,25,58,67,2001,2010,16659.164857988482,0.01655373982940357,25.7797492262188,20.05947514203957,517.1282387713499,9,4654.154148942149,134604.54256292502,129950.38841398287
209,1940,1968,28,65,64,2005,2004,20178.13737688573,0.03347217588817502,46.98812484865428,22.577115996341544,0.0,0,0.0,254704.40059208433,254704.40059208433
210,1949,1969,20,58,70,2007,2019,17145.483431401793,0.009972069637967259,27.13250384586369,23.952062360518745,649.8794241131418,12,7798.5530893577015,146466.2065487022,138667.6534593445
211,1944,1969,25,65,69,2009,2013,38879.47955664624,0.05222048627886367,159.6542077847937,25.410742958274337,4056.9320362263143,4,16227.728144905257,922389.3215456412,906161.5934007359
212,1946,1969,23,62,65,2008,2011,36890.07455563359,0.005650096175536802,55.292976394132644,24.67062423133431,1364.1122432516847,3,4092.336729755054,298435.8249597818,294343.48823002673
213,1945,1969,24,58,65,2003,2010,35443.84286400651,0.011138844483135426,51.251529585444885,21.281097178189782,1090.6887816387214,7,7634.821471471049,270690.0881686292,263055.26669715816
214,1949,1969,20,61,70,2010,2019,31118.384054155285,0.0505312001770152,128.97238975771597,26.17306524702257,3375.6027721931255,9,30380.424949738128,749901.8502932049,719521.4253434668
215,1947,1969,22,61,69,2008,2016,17782.703002938775,0.023984620408363348,37.89121866960242,24.67062423133431,934.8000174650803,8,7478.400139720642,209649.27980962317,202170.87966990253
216,1945,1969,24,64,70,2009,2015,34919.63519695749,0.02225960724406378,74.16035830842938,25.410742958274337,1884.4698026690237,6,11306.818816014142,412117.11599342653,400810.2971774124
217,1943,1969,26,59,63,2002,2006,18833.97278625753,0.052422665348107834,53.88600228235485,20.66125939630076,1113.3526709853884,4,4453.4106839415535,293930.3090495635,289476.8983656219
218,1946,1969,23,65,59,2011,2005,36054.03927693739,0.029371559912475684,76.80686918892876,26.958257204433245,0.0,0,0.0,419030.14410439326,419030.14410439326
219,1945,1969,24,58,60,2003,2005,10674.079249603521,0.018433867969247304,17.423318281736922,21.281097178189782,370.78732952017407,2,741.5746590403481,92718.22603842009,91976.65137937975
220,1944,1969,25,59,67,2003,2011,17736.63056299607,0.011967803703641207,25.99730018119171,21.281097178189782,553.2510715265116,8,4426.008572212093,137425.5629783696,132999.5544061575
221,1941,1969,28,61,68,2002,2009,25770.705469080574,0.013583964292415176,37.60177954897733,20.66125939630076,776.9001210239377,7,5438.300847167564,197918.8463928747,192480.54554570714
222,1945,1969,24,62,69,2007,2014,34677.516277350216,0.03148308393275406,83.01214402236555,23.952062360518745,1988.312050304063,7,13918.18435212844,460467.82315079914,446549.6387986707
223,1942,1969,27,61,67,2003,2009,18221.65662061618,0.03270890012578967,38.14205677733792,21.281097178189782,811.7048168545605,6,4870.228901127362,205898.81875680934,201028.589855682
224,1944,1970,26,63,68,2007,2012,31606.077448968874,0.010328936506433718,48.500275074660706,23.952062360518745,1161.681613090586,5,5808.408065452931,263285.149200955,257476.74113550206
225,1947,1970,23,62,69,2009,2016,37000.55925544315,0.04869450387812576,131.98778803798683,25.410742958274337,3353.9077554644796,7,23477.354288251358,761385.4737968176,737908.1195085662
226,1945,1970,25,59,70,2004,2015,28992.94190072343,0.029713692506913573,56.906079288727746,21.919530093535478,1247.3545174743838,11,13720.899692218221,309656.1027371501,295935.20304493187
227,1943,1970,27,58,68,2001,2011,22131.44504647073,0.04354556885321353,48.19788562673348,20.05947514203957,966.8242886283266,10,9668.242886283266,259818.2480508102,250150.00516452693
228,1951,1970,19,63,69,2014,2020,15531.127620368898,0.009516848028880394,27.795505960089642,29.45801552022873,818.8004459649309,6,4912.802675789585,156944.91837260424,152032.11569681467
229,1950,1970,20,67,63,2017,2013,35112.36972109089,0.02685966981786218,89.51809604633071,32.18956892537298,0.0,0,0.0,516914.0438529426,516914.0438529426
230,1949,1970,21,58,69,2007,2018,18913.65146869525,0.03332023201484486,44.70721890493573,23.952062360518745,1070.830095176383,11,11779.131046940214,249456.67981345236,237677.54876651213
231,1951,1970,19,64,66,2015,2017,38104.89217974274,0.041628604860512515,149.4343327055042,30.34175598583559,4534.100058856579,2,9068.200117713159,896787.9892771104,887719.7891593972
232,1952,1970,18,67,62,2019,2014,26195.283367245804,0.01310069389457923,50.60104343880206,34.1499136729282,0.0,0,0.0,287498.46143267024,287498.46143267024
233,1949,1970,21,58,69,2007,2018,27905.285467506677,0.021712194540848044,52.720535177456874,23.952062360518745,1262.7655462503692,11,13890.421008754061,290186.636318292,276296.21530953795
234,1943,1970,27,59,63,2002,2006,20331.511961326996,0.022577008056710944,32.757734071348104,20.66125939630076,676.8160408831626,4,2707.2641635326504,174706.5318902506,171999.26772671795
235,1952,1970,18,66,69,2018,2021,27948.58174804464,0.02798407563805656,85.5235966702151,33.15525599313417,2835.5567410545386,3,8506.670223163615,512964.2162014644,504457.5459783008
236,1950,1970,20,60,60,2010,2010,33982.47636906938,0.039734823542721336,103.77737648024005,26.17306524702257,2716.1720457821484,0,0.0,596889.4643693899,596889.4643693899
237,1947,1970,23,59,70,2006,2017,20829.216908200804,0.009579103666331707,30.71031447236495,23.25442947623179,714.1508420905111,11,7855.659262995622,165604.57302175785,157748.91375876224
238,1943,1971,28,58,59,2001,2002,38507.12061462407,0.02730028864789779,61.05722126618599,20.05947514203957,1224.7758122310677,1,1224.7758122310677,326231.38439303526,325006.6085808042
239,1946,1971,25,60,66,2006,2012,29168.481560027856,0.04295179227694249,75.53353633913315,23.25442947623179,1756.4892938887629,6,10538.935763332578,424107.097073116,413568.1613097834
240,1949,1971,22,63,64,2012,2013,39417.304005399645,0.050168190631801245,158.44955825626928,27.767004920566244,4399.669663763377,1,4399.669663763377,941247.5325054702,936847.8628417068
241,1943,1971,28,67,67,2010,2010,38321.780190598394,0.006971340568425295,57.570790307296285,26.17306524702257,1506.8040510355202,0,0.0,318181.55318785034,318181.55318785034
242,1944,1971,27,64,59,2008,2003,15417.260353820006,0.03339726152763147,29.356865632462252,24.67062423133431,0.0,0,0.0,159812.56621055488,159812.56621055488
243,1944,1971,27,64,63,2008,2007,31930.71014374845,0.014629951389281522,50.845386932569326,24.67062423133431,0.0,0,0.0,278830.5976425921,278830.5976425921
244,1946,1971,25,59,69,2005,2015,38327.994673403016,0.02871071083287319,73.10132523807957,22.577115996341544,1650.417099386412,10,16504.17099386412,401759.0282038385,385254.8572099744
245,1950,1971,21,64,61,2014,2011,19573.01419729767,0.04644577370753387,68.79821546242702,29.45801552022873,0.0,0,0.0,403446.25854916964,403446.25854916964
246,1953,1971,18,65,61,2018,2014,26820.31582010542,0.029053094192204323,71.11763791294302,33.15525599313417,0.0,0,0.0,416608.29778379446,416608.29778379446
247,1951,1971,20,62,69,2013,2020,20196.248913041985,0.04123833857643807,68.62184323307451,28.600015068183232,1962.5857504724388,7,13738.100253307071,406173.58895501867,392435.4887017116
248,1947,1971,24,65,59,2012,2006,26152.044711423627,0.03808275875402707,61.704609099636805,27.767004920566244,0.0,0,0.0,344779.07991156145,344779.07991156145
249,1952,1971,19,58,68,2010,2020,36299.96133587348,0.025875304201394608,78.62277522811503,26.17306524702257,2057.7990259474445,10,20577.990259474445,445743.0360301098,425165.04577063536
250,1951,1971,20,67,60,2018,2011,10638.082325511614,0.04873508363420997,39.41312605733123,33.15525599313417,0.0,0,0.0,231773.70295738344,231773.70295738344
251,1952,1971,19,60,69,2012,2021,39938.02331600012,0.02253559077258551,86.06418475608336,27.767004920566244,2389.744641606689,9,21507.7017744602,492318.8376979114,470811.1359234512
252,1954,1972,18,62,70,2016,2024,28825.1638965511,0.04868385570931694,127.14600489846612,31.25200866541066,3973.5680468592095,8,31788.544374873676,781658.9859548628,749870.4415799892
253,1946,1972,26,67,67,2013,2013,20091.113914852664,0.03112595958172616,51.54619111197627,28.600015068183232,1474.2218425099738,0,0.0,301807.3720430331,301807.3720430331
254,1954,1972,18,58,61,2012,2015,24019.322996129576,0.019850143822744113,46.99777200880651,27.767004920566244,1304.9873666241808,3,3914.9620998725422,268976.6431932775,265061.68109340494
255,1953,1972,19,61,60,2014,2013,17008.2325314973,0.007104659481818094,26.534700816945453,29.45801552022873,0.0,0,0.0,149958.36541402727,149958.36541402727
256,1954,1972,18,62,67,2016,2021,13284.027960373454,0.024581507027017804,32.43763283938139,31.25200866541066,1013.7411825817567,5,5068.705912908783,192088.58282300865,187019.87691009988
257,1951,1972,21,67,63,2018,2014,33590.35043246656,0.009470550115612975,56.17037930874566,33.15525599313417,0.0,0,0.0,320425.8077369573,320425.8077369573
258,1949,1972,23,64,66,2013,2015,36525.96934394509,0.0350399223221099,102.23850007650431,28.600015068183232,2924.022642736476,2,5848.045285472952,601891.1495150849,596043.1042296119
259,1953,1972,19,66,65,2019,2018,39735.05878410929,0.01658358506917217,85.18435005709138,34.1499136729282,0.0,0,0.0,504044.3620614716,504044.3620614716
260,1951,1972,21,63,63,2014,2014,34919.27553251874,0.011016938101749797,60.24387329482589,29.45801552022873,1774.6649545176742,0,0.0,344507.3097726876,344507.3097726876
261,1944,1972,28,59,67,2003,2011,16614.58627210526,0.014321913107212727,22.225786298041793,21.281097178189782,472.98911807030635,8,3783.912944562451,119538.689598212,115754.77665364955
262,1952,1972,20,65,64,2017,2016,34023.09061389625,0.03648889614980765,110.32160452863795,32.18956892537298,0.0,0,0.0,665972.7515102153,665972.7515102153
263,1948,1972,24,58,67,2006,2015,37832.568495856394,0.05474539113232176,115.66708123826668,23.25442947623179,2689.7719833768456,9,24207.94785039161,658600.0341915537,634392.0863411621
264,1944,1972,28,67,61,2011,2005,32747.154271122738,0.03980103090268961,72.06866081515568,26.958257204433245,0.0,0,0.0,401782.10033988993,401782.10033988993
265,1947,1972,25,60,61,2007,2008,16733.21715509982,0.016190880741131154,26.271676653109335,23.952062360518745,629.2608375106591,1,629.2608375106591,145023.7231765701,144394.46233905945
266,1947,1973,26,66,62,2013,2009,27402.586235134335,0.009574341869887744,39.094338744523924,28.600015068183232,0.0,0,0.0,217847.70342897717,217847.70342897717
267,1947,1973,26,65,61,2012,2008,18188.781245689446,0.028833841416518423,35.3525238762841,27.767004920566244,0.0,0,0.0,199988.67968525743,199988.67968525743
268,1953,1973,20,66,60,2019,2013,35863.82851796351,0.0454758037362439,120.62847254125467,34.1499136729282,0.0,0,0.0,722171.5119628276,722171.5119628276
269,1948,1973,25,66,63,2014,2011,32056.379635703583,0.01906954802887634,57.53334151251841,29.45801552022873,0.0,0,0.0,328291.49767732853,328291.49767732853
270,1950,1973,23,65,69,2015,2019,31702.60341065755,0.029793786753938543,80.87110443843841,30.34175598583559,2453.771317176124,4,9815.085268704495,481276.71847631386,471461.63320760935
271,1950,1973,23,62,70,2012,2020,13284.065801633617,0.04972399654840337,46.92835299914509,27.767004920566244,1303.0598086413313,8,10424.47846913065,280076.4521773537,269651.9737082231
272,1955,1973,18,59,66,2014,2021,36487.18807412384,0.030803951022180833,91.9393513956189,29.45801552022873,2708.3508403319047,7,18958.45588232333,543987.2695244642,525028.8136421408
273,1953,1973,20,67,61,2020,2014,20434.27623706579,0.03890080762795318,61.74479466438925,35.17441108311604,0.0,0,0.0,369439.98991805274,369439.98991805274
274,1945,1973,28,58,64,2003,2009,25637.809365412446,0.04840804020257735,55.56029186148309,21.281097178189782,1182.3839703528083,6,7094.30382211685,308296.23735403665,301201.9335319198
275,1955,1973,18,66,69,2021,2024,17160.700939030525,0.05150451752548693,97.24907242719074,36.22964341560952,3523.2992165359046,3,10569.897649607714,628485.3565887738,617915.458939166
276,1952,1973,21,63,70,2015,2022,14758.15315879221,0.04904353795994642,59.22927824034137,30.34175598583559,1797.1203075855994,7,12579.842153099196,362139.1331502562,349559.290997157
277,1946,1973,27,66,61,2012,2007,36372.144406843945,0.005257258537735739,45.79350584545893,27.767004920566244,0.0,0,0.0,251136.21606972913,251136.21606972913
278,1945,1973,28,62,65,2007,2010,14822.796881449245,0.04589835120595311,37.852802626704424,23.952062360518745,906.6526890352321,3,2719.9580671056965,216172.69788716032,213452.73982005462
279,1949,1973,24,59,69,2008,2018,39435.585340822705,0.03659067635083342,88.50372301104751,24.67062423133431,2183.4420934796485,10,21834.420934796486,504696.25663258275,482861.83569778624
280,1955,1974,19,65,61,2020,2016,13853.461542795741,0.01916714741327908,27.69810665369768,35.17441108311604,0.0,0,0.0,163979.9616875328,163979.9616875328
281,1950,1974,24,67,67,2017,2017,38889.76011576984,0.022093608301934305,85.26206580186033,32.18956892537298,2744.5491438486697,0,0.0,510475.21878199594,510475.21878199594
282,1952,1974,22,63,62,2015,2014,15212.604259227004,0.04354270542704949,48.43679048841786,30.34175598583559,0.0,0,0.0,292462.57295268856,292462.57295268856
283,1953,1974,21,58,70,2011,2023,12020.51804406315,0.03410852300881367,27.625599592706266,26.958257204433245,744.7380192468618,12,8936.856230962341,161185.4433493812,152248.58711841886
284,1956,1974,18,63,68,2019,2024,12240.832532735621,0.04762073295993238,53.74673314021151,34.1499136729282,1835.4462969401322,5,9177.231484700662,340081.72921848134,330904.4977337807
285,1953,1974,21,60,62,2013,2015,32747.895877870676,0.006229345822940076,46.965691677396734,28.600015068183232,1343.2194896611945,2,2686.438979322389,267956.16944488656,265269.7304655642
286,1946,1974,28,58,64,2004,2010,21155.005877161737,0.045939282167854686,43.55638328374837,21.919530093535478,954.735454153688,6,5728.412724922128,243908.3625266957,238179.9498017736
287,1946,1974,28,67,65,2013,2011,23377.08119130245,0.018681333314083295,39.95081567131458,28.600015068183232,0.0,0,0.0,228898.44766139484,228898.44766139484
288,1953,1974,21,58,61,2011,2014,23541.610729890264,0.013181191059583458,36.387071110913176,26.958257204433245,980.932021924,3,2942.796065772,207088.3544274297,204145.5583616577
289,1950,1974,24,61,60,2011,2010,33184.68340050413,0.016502684151571696,52.8605099618529,26.958257204433245,0.0,0,0.0,300201.2489691667,300201.2489691667
290,1946,1974,28,60,59,2006,2005,38897.099603203955,0.006565115687375812,45.3860403452304,23.25442947623179,0.0,0,0.0,247835.5362250303,247835.5362250303
291,1952,1974,22,62,69,2014,2021,38935.61416810626,0.043004703921904856,122.4722405965759,29.45801552022873,3607.78916429112,7,25254.52415003784,738990.7299446093,713736.2057945715
292,1952,1974,22,60,69,2012,2021,22280.02018945129,0.049704960183956724,74.08708295583256,27.767004920566244,2057.176396985002,9,18514.58757286502,443351.7649296389,424837.1773567739
293,1955,1974,19,60,59,2015,2014,29550.004761276552,0.02342631718618806,60.8596943132794,30.34175598583559,0.0,0,0.0,357799.2046831008,357799.2046831008
294,1947,1975,28,65,70,2012,2017,15565.765471093633,0.04843115839778054,47.42460467302004,27.767004920566244,1316.8392313116565,5,6584.196156558282,284201.5283400079,277617.3321834496
295,1953,1975,22,65,69,2018,2022,35343.496843506626,0.04305119954714994,125.23219764745242,33.15525599313417,4152.105571584059,4,16608.422286336237,782661.4307611152,766053.008474779
296,1955,1975,20,62,66,2017,2021,37625.43543447061,0.0358325157260369,107.79239164675039,32.18956892537298,3469.7906205438703,4,13879.162482175481,661490.1117620919,647610.9492799164
297,1949,1975,26,64,59,2013,2008,28219.193447880138,0.017376997780168758,40.99439943237633,28.600015068183232,0.0,0,0.0,231264.9117745541,231264.9117745541
298,1949,1975,26,63,67,2012,2016,14824.7640723457,0.037575973340113235,36.12126207103831,27.767004920566244,1002.9792616635835,4,4011.917046654334,213912.15535391888,209900.23830726455
299,1953,1975,22,62,60,2015,2013,33926.773019115644,0.02051809794617869,61.249004364414276,30.34175598583559,0.0,0,0.0,357882.76537844114,357882.76537844114
300,1957,1975,18,65,63,2022,2020,12173.406633836767,0.024624677820334243,29.66635826380755,37.31653271807781,0.0,0,0.0,182820.50014490238,182820.50014490238
301,1952,1975,23,66,59,2018,2011,38579.45914116151,0.05039093264923201,116.42919748441076,33.15525599313417,0.0,0,0.0,693492.1569952775,693492.1569952775
302,1947,1975,28,63,61,2010,2008,13147.905352545245,0.017102250793126373,19.014912352322504,26.17306524702257,0.0,0,0.0,107241.80377550266,107241.80377550266
303,1949,1975,26,63,64,2012,2013,16310.48739756606,0.02230082838224198,29.49951560056964,27.767004920566244,819.1131948353379,1,819.1131948353379,171622.58050076358,170803.46730592824
304,1950,1975,25,59,70,2009,2020,12172.488164390244,0.03171211029882225,23.438914514562033,25.410742958274337,595.6002319505013,11,6551.602551455515,134980.1232597364,128428.52070828088
305,1949,1975,26,58,62,2007,2011,20734.04052784814,0.02110473511096677,30.88912718581407,23.952062360518745,739.8583006166134,4,2959.4332024664536,173772.52685148557,170813.0936490191
306,1952,1975,23,64,68,2016,2020,30683.949074117972,0.045029334955454144,104.53394667522024,31.25200866541066,3266.8958073235585,4,13067.583229294234,644507.828891992,631440.2456626977
307,1956,1975,19,67,65,2023,2021,30111.563750632366,0.05257749871776635,156.66658180662887,38.43602869962015,0.0,0,0.0,1018428.5370458682,1018428.5370458682
308,1956,1976,20,63,67,2019,2023,38086.36738731069,0.007598564182573621,60.024202613540965,34.1499136729282,2049.821337538775,4,8199.2853501551,358677.253161953,350477.9678117979
309,1950,1976,26,59,70,2009,2020,36129.07371238257,0.04070434660662139,77.34286658598344,25.410742958274337,1965.3397024725302,11,21618.736727197833,450837.9892423362,429219.25251513836
310,1955,1976,21,64,69,2019,2024,36844.499681815825,0.03237961880768681,99.92772017587647,34.1499136729282,3412.5230175387073,5,17062.615087693535,621474.9578921376,604412.342804444
311,1949,1976,27,63,68,2012,2017,24427.114943469547,0.007037705304623639,32.29502592862949,27.767004920566244,896.7361438700696,5,4483.680719350348,185412.8614225375,180929.18070318716
312,1949,1976,27,59,64,2008,2013,27798.35944930536,0.03751470929367269,53.73017130544465,24.67062423133431,1325.556866161846,5,6627.784330809231,310038.99718922516,303411.2128584159
313,1950,1976,26,60,68,2010,2018,19870.523134439863,0.028509129634833257,35.753428779893746,26.17306524702257,935.7768242609336,8,7486.214594087469,207504.21074223763,200017.99614815015
314,1951,1976,25,64,63,2015,2014,29761.233265026283,0.02990978582265695,63.9289989101512,30.34175598583559,0.0,0,0.0,382102.07226480386,382102.07226480386
315,1957,1976,19,63,60,2020,2017,29597.890577119902,0.02161573126775545,59.22832053426404,35.17441108311604,0.0,0,0.0,357375.0672019081,357375.0672019081
316,1951,1976,25,66,69,2017,2020,29509.770590408105,0.014977122546457257,51.49496146922533,32.18956892537298,1657.6006115230548,3,4972.801834569164,307670.2836501852,302697.4818156161
317,1956,1976,20,63,59,2019,2015,35213.572188308004,0.013709666828912684,56.82016922292677,34.1499136729282,0.0,0,0.0,334760.05636480416,334760.05636480416
318,1954,1976,22,67,66,2021,2020,22764.80003344226,0.022296749627348147,50.492999153829,36.22964341560952,0.0,0,0.0,311193.1388849399,311193.1388849399
319,1955,1976,21,65,60,2020,2015,36010.94488367345,0.03393377042861967,87.25397234263838,35.17441108311604,0.0,0,0.0,527937.446958286,527937.446958286
320,1955,1976,21,67,63,2022,2018,21865.455095470457,0.035309435678058575,61.21471216770472,37.31653271807781,0.0,0,0.0,379503.1032922804,379503.1032922804
321,1957,1976,19,61,64,2018,2021,29650.280164963257,0.05460666581703362,132.17409359362583,33.15525599313417,4382.265908757139,3,13146.797726271418,841107.1545338875,827960.3568076161
322,1950,1977,27,63,70,2013,2020,21515.414556033887,0.02829064035101243,41.14778160402293,28.600015068183232,1176.8271738973685,7,8237.79021728158,244726.1635501303,236488.3733328487
323,1955,1977,22,58,61,2013,2016,33280.006211062886,0.025265509154287172,60.15353433346317,28.600015068183232,1720.391988341524,3,5161.175965024572,356555.77862824843,351394.60266322386
324,1953,1977,24,67,70,2020,2023,21185.459115668033,0.03063076026029026,54.56175527423155,35.17441108311604,1919.1776094321954,3,5757.532828296586,342144.01783565764,336386.48500736104
325,1955,1977,22,62,64,2017,2019,24768.335693441044,0.017361553720158854,43.64247251555651,32.18956892537298,1404.8323771132023,2,2809.6647542264045,262892.07846533816,260082.41371111176
326,1952,1977,25,64,67,2016,2019,29878.63837024961,0.009763075397731316,44.26478156094148,31.25200866541066,1383.3633369150532,3,4150.09001074516,262241.7593546408,258091.66934389563
327,1959,1977,18,66,67,2025,2026,21971.378384113334,0.04789931269613529,107.38401962981754,40.77678284742702,4378.77484972891,0,0.0,720764.6964368677,720764.6964368677
328,1955,1977,22,58,66,2013,2021,27961.419403003227,0.0248329888171781,50.13699156622092,28.600015068183232,1433.918714267294,8,11471.349714138352,297039.011779841,285567.6620657026
329,1953,1977,24,67,61,2020,2014,23260.731213485727,0.0215444681494586,40.57797893721046,35.17441108311604,0.0,0,0.0,241078.65349912737,241078.65349912737
330,1950,1977,27,66,59,2016,2009,23483.01505641213,0.03439421855551935,42.58269796894561,31.25200866541066,0.0,0,0.0,247751.72315980363,247751.72315980363
331,1959,1977,18,66,64,2025,2023,15028.57648864953,0.006833571346677149,24.528363241635336,40.77678284742702,0.0,0,0.0,150490.89970248635,150490.89970248635
332,1955,1977,22,62,70,2017,2025,24238.926272494416,0.047208522448459855,81.19315544789508,32.18956892537298,2613.5726735585413,8,20908.58138846833,508910.8202045969,488002.2388161286
333,1952,1977,25,63,70,2015,2022,26197.175185066375,0.006709388296957909,35.81240658151843,30.34175598583559,1086.6113017619648,7,7606.279112333754,210108.773895957,202502.49478362326
334,1958,1977,19,66,63,2024,2021,38098.170768848846,0.006967177033425483,59.88097710955937,39.589109560608755,0.0,0,0.0,363400.5767411794,363400.5767411794
335,1953,1977,24,60,64,2013,2017,15400.313124181705,0.00942777921116207,20.97750956091548,28.600015068183232,599.9570895351405,4,2399.828358140562,122102.16067810114,119702.33231996058
336,1960,1978,18,58,61,2018,2021,11247.185771511762,0.012417160048104444,17.781384482732964,33.15525599313417,589.546354437355,3,1768.639063312065,107528.76641874554,105760.12735543348
337,1956,1978,22,59,66,2015,2022,30579.032079489523,0.005868989509273982,39.75878988432809,30.34175598583559,1206.3515009623914,7,8444.46050673674,234277.8987147756,225833.43820803886
338,1952,1978,26,59,67,2011,2019,27403.366890864043,0.017711228994874664,38.734344384809134,26.958257204433245,1044.2104185707792,8,8353.683348566234,225878.6713801363,217524.98803157007
339,1950,1978,28,59,65,2009,2015,30005.92772638313,0.011982562737815646,36.29572879198557,25.410742958274337,922.3014348163824,6,5533.808608898295,208036.26501040376,202502.45640150548
340,1957,1978,21,59,68,2016,2025,31986.967550240253,0.013119094733116045,48.60000301852908,31.25200866541066,1518.8477154740551,9,13669.629439266497,290680.3826555386,277010.7532162721
341,1956,1978,22,58,65,2014,2021,30178.063546753787,0.02718751096522856,55.91881427654877,29.45801552022873,1647.2572988313616,7,11530.80109181953,335822.4645848671,324291.6634930476
342,1956,1978,22,63,60,2019,2016,29848.9705111344,0.05393156437002652,104.24250937283591,34.1499136729282,0.0,0,0.0,654710.4135822828,654710.4135822828
343,1950,1978,28,67,60,2017,2010,17324.418712671228,0.046543859567085274,38.30265105427332,32.18956892537298,0.0,0,0.0,227624.4980820261,227624.4980820261
344,1953,1978,25,58,70,2011,2023,13393.29457229719,0.04477551858482016,30.182112839541894,26.958257204433245,813.6571609015974,12,9763.88593081917,180475.65471138444,170711.76878056527
345,1957,1978,21,58,59,2015,2016,16470.254571931517,0.03794427351163286,39.1244603568589,30.34175598583559,1187.1048292253106,1,1187.1048292253106,239526.76119647926,238339.65636725395
346,1956,1978,22,62,67,2018,2023,13197.790909239722,0.0378922652301518,35.447546483373,33.15525599313417,1175.2724779847547,5,5876.362389923774,222000.43189989473,216124.06950997096
347,1959,1978,19,63,67,2022,2026,35993.16002582936,0.054666846867931426,173.91527934052712,37.31653271807781,6489.915211684422,3,19469.745635053267,1151278.9767422455,1131809.231107192
348,1952,1978,26,62,67,2014,2019,13273.288952972493,0.03752558238958579,29.96836027143139,29.45801552022873,882.808421991632,5,4414.04210995816,182020.81091060452,177606.76880064636
349,1955,1978,23,61,64,2016,2019,23145.17039235963,0.050068782479422216,74.25532270652408,31.25200866541066,2320.6279886771554,3,6961.883966031466,464421.131787239,457459.2478212075
350,1953,1979,26,64,61,2017,2014,36067.01876621713,0.023783612594086328,59.928043066069236,32.18956892537298,0.0,0,0.0,360080.03470259503,360080.03470259503
351,1956,1979,23,64,67,2020,2023,19851.43683655243,0.03651043741645721,53.20278801586268,35.17441108311604,1871.3767364378336,3,5614.130209313501,338823.64289435645,333209.512685043
352,1952,1979,27,64,63,2016,2015,21412.59112698393,0.03242498608257384,43.33094727634716,31.25200866541066,0.0,0,0.0,264614.28976746503,264614.28976746503
353,1961,1979,18,58,59,2019,2020,23332.58358253605,0.005733352852313191,32.1196694429414,34.1499136729282,1096.8839386794386,1,1096.8839386794386,194489.7354524847,193392.85151380525
354,1951,1979,28,60,66,2011,2017,30046.383956650487,0.03597451730048073,54.748097265435035,26.958257204433245,1475.913287534926,6,8855.479725209556,326022.03875869873,317166.5590334892
355,1953,1979,26,60,63,2013,2016,35900.009487154755,0.030954089256810906,65.27908966345724,28.600015068183232,1866.9829480121614,3,5600.948844036484,392452.6399357198,386851.6910916833
356,1956,1979,23,62,68,2018,2024,13267.550255401944,0.012449592798509736,20.226733933681246,33.15525599313417,670.6225414762154,6,4023.7352488572924,122932.17824438485,118908.44299552756
357,1957,1979,22,61,69,2018,2026,32946.49784626385,0.045649286935804674,99.52310952344294,33.15525599313417,3299.71417348248,7,23097.99921437736,631255.9279625202,608157.9287481428
358,1960,1979,19,62,65,2022,2025,22925.862746141,0.04983571449200612,92.1028266824831,37.31653271807781,3436.9581453243304,3,10310.874435972992,607087.604002004,596776.729566031
359,1957,1979,22,66,62,2023,2019,37811.036343889195,0.008013369514478043,54.33355018922017,38.43602869962015,0.0,0,0.0,330085.0827166389,330085.0827166389
360,1957,1979,22,63,61,2020,2018,13042.624853476496,0.029293587959316286,27.75903363821161,35.17441108311604,0.0,0,0.0,172536.24556275792,172536.24556275792
361,1957,1979,22,61,69,2018,2026,37888.176322659674,0.03161301066695201,84.61642383572195,33.15525599313417,2805.479193496901,7,19638.35435447831,527502.571881185,507864.21752670675
362,1954,1979,25,67,62,2021,2016,31529.073577258885,0.02499526034020781,57.44410871928595,36.22964341560952,0.0,0,0.0,350270.57096232404,350270.57096232404
363,1958,1979,21,67,67,2025,2025,25674.43121548355,0.011161132708608303,45.082503230226386,40.77678284742702,1838.3194444373687,0,0.0,285058.8999735622,285058.8999735622
364,1953,1980,27,64,65,2017,2018,18858.348676609305,0.04467036290739187,50.29246476306954,32.18956892537298,1618.8927609177188,1,1618.8927609177188,317053.2563048709,315434.36354395316
365,1953,1980,27,65,62,2018,2015,22735.822755890855,0.009351948129382932,29.12276588666031,33.15525599313417,0.0,0,0.0,174154.12673082322,174154.12673082322
366,1957,1980,23,58,70,2015,2027,11302.375985644576,0.03665756877970112,23.525126990291888,30.34175598583559,713.7936626752313,10,7137.936626752313,144839.88150919593,137701.9448824436
367,1952,1980,28,64,64,2016,2016,34575.665782803706,0.04921032316742039,96.43767502616389,31.25200866541066,3013.871055589731,0,0.0,605995.178380847,605995.178380847
368,1954,1980,26,67,67,2021,2021,29398.177402685804,0.013738672141368858,47.892096638387024,36.22964341560952,1735.1135836346734,0,0.0,298389.1928670649,298389.1928670649
369,1954,1980,26,67,66,2021,2020,33098.34100755036,0.032831852896835864,77.86886188114009,36.22964341560952,0.0,0,0.0,495156.96573994437,495156.96573994437
370,1952,1980,28,62,62,2014,2014,18244.181066444085,0.04613071592568392,43.34463182978797,29.45801552022873,1276.8468371604943,0,0.0,267293.99351436476,267293.99351436476
371,1956,1980,24,67,67,2023,2023,12866.059415040045,0.03619296623382865,36.551592919712014,38.43602869962015,1404.8980744788837,0,0.0,238867.13249107724,238867.13249107724
372,1962,1980,18,64,60,2026,2022,14589.514024856879,0.01676177924009924,25.96301112603675,42.00008633284983,0.0,0,0.0,163522.1726680913,163522.1726680913
373,1961,1980,19,58,65,2019,2026,26060.743055279825,0.013922298261388605,40.4145115499064,34.1499136729282,1380.1520805628631,6,8280.912483377178,248827.59497564996,240546.68249227278
374,1958,1980,22,60,70,2018,2028,16185.584935552793,0.03689803966579851,38.38409891370867,33.15525599313417,1272.634625549794,7,8908.442378848558,241711.5581802373,232803.11580138875
375,1954,1980,26,66,67,2020,2021,39633.56560644662,0.011821987627836657,60.598918108145625,35.17441108311604,2131.531256727999,1,2131.531256727999,374244.61876842397,372113.087511696
376,1958,1980,22,59,61,2017,2019,23281.509003385814,0.027289545728861452,43.84395889802866,32.18956892537298,1411.3181369093136,2,2822.636273818627,271016.5246582541,268193.8883844355
377,1954,1980,26,58,69,2012,2023,39737.67981106565,0.011419714472706262,48.149263347221364,27.767004920566244,1336.9608322839356,11,14706.569155123292,283587.16471457866,268880.59555945534
378,1961,1981,20,61,68,2022,2029,20116.813982662614,0.05027623961648369,72.67320795489437,37.31653271807781,2711.912142376488,3,8135.736427129465,481678.7060452987,473542.96961816924
379,1960,1981,21,65,63,2025,2023,36825.72623992355,0.014593366235937145,61.95532214618859,40.77678284742702,0.0,0,0.0,393165.7772654182,393165.7772654182
380,1956,1981,25,58,69,2014,2025,20306.814243271117,0.03585778916978234,37.77309246754954,29.45801552022873,1112.7203441561094,11,12239.923785717203,231545.7389266369,219305.8151409197
381,1963,1981,18,59,70,2022,2033,34010.69523467084,0.016685604095521653,58.17738616437421,37.31653271807781,2170.9783342551177,3,6512.935002765353,368077.0951206154,361564.16011785006
382,1959,1981,22,65,64,2024,2023,27784.35974960268,0.039006596555172565,80.27479658426606,39.589109560608755,0.0,0,0.0,528425.0648348472,528425.0648348472
383,1954,1981,27,60,64,2014,2018,30084.608655945704,0.054706968061058375,78.76748133716465,29.45801552022873,2320.3336877195234,4,9281.334750878093,490864.40538603836,481583.07063516026
384,1962,1981,19,63,59,2025,2021,39864.414721127716,0.027317617559882112,82.4748448707286,40.77678284742702,0.0,0,0.0,526281.3038193136,526281.3038193136
385,1960,1981,21,65,64,2025,2024,26868.904476337295,0.05288126422526901,114.11990732769111,40.77678284742702,0.0,0,0.0,772006.8070951768,772006.8070951768
386,1955,1981,26,64,68,2019,2023,12900.293489401589,0.02751854681290926,25.010449399089914,34.1499136729282,854.1046879000595,4,3416.418751600238,157427.33428263816,154010.91553103793
387,1963,1981,18,65,62,2028,2025,24246.59630518656,0.024126314012200414,53.095096931314316,44.557891590520384,0.0,0,0.0,346687.47747787525,346687.47747787525
388,1957,1981,24,60,66,2017,2023,10600.790677774734,0.041859011250362156,25.224471855411366,32.18956892537298,811.9648753958951,6,4871.789252375371,159046.07953124584,154174.29027887047
389,1956,1981,25,58,67,2014,2023,30146.75330839112,0.009646457218969496,36.23842785662816,29.45801552022873,1067.5121702292415,9,9607.609532063174,216665.44808642662,207057.83855436344
390,1958,1981,23,59,66,2017,2024,32658.11261490424,0.011385674181761743,44.043774784146414,32.18956892537298,1417.7501241478856,7,9924.250869035199,268441.6600910074,258517.40922197222
391,1958,1981,23,61,60,2019,2018,11893.270992374506,0.01088245142367793,16.34117230573963,34.1499136729282,0.0,0,0.0,100120.73110439014,100120.73110439014
392,1958,1982,24,59,60,2017,2018,21427.285765329616,0.022316088429450178,33.56542932082684,32.18956892537298,1080.4567006324908,1,1080.4567006324908,208081.0091813307,207000.5524806982
393,1956,1982,26,66,59,2022,2015,19165.729319740705,0.024849075853714174,29.18470847383154,37.31653271807781,0.0,0,0.0,179022.71614851593,179022.71614851593
394,1958,1982,24,67,62,2025,2020,36200.09985171544,0.01308821056760548,52.616279511891165,40.77678284742702,0.0,0,0.0,328765.9656338348,328765.9656338348
395,1959,1982,23,63,70,2022,2029,35542.74873235288,0.015425525717866793,57.05457608961607,37.31653271807781,2129.078955364218,3,6387.236866092654,362010.0305433085,355622.7936772158
396,1964,1982,18,67,64,2031,2028,34523.49125473575,0.024031164673829007,79.1070030565694,48.68961120403458,0.0,0,0.0,529423.9093002606,529423.9093002606
397,1957,1982,25,67,64,2024,2021,14238.341478265174,0.015599124545111927,22.309005731510304,39.589109560608755,0.0,0,0.0,140711.98660109393,140711.98660109393
398,1956,1982,26,62,61,2018,2017,15205.73544959526,0.03974755444512308,32.831608762939794,33.15525599313417,0.0,0,0.0,207255.47154509372,207255.47154509372
399,1963,1982,19,61,60,2024,2023,29229.16232035996,0.04612402818171805,94.63985049490331,39.589109560608755,0.0,0,0.0,630838.127302395,630838.127302395
400,1956,1982,26,63,59,2019,2015,37682.715715401835,0.0293530959409468,61.93824876074645,34.1499136729282,0.0,0,0.0,381552.2218254334,381552.2218254334
401,1959,1982,23,61,61,2020,2020,38583.92582803883,0.046260038370778404,109.10127716226724,35.17441108311604,3837.573172598568,0,0.0,709870.6949432861,709870.6949432861
402,1960,1982,22,59,66,2019,2026,24347.02069144217,0.030305377742337544,47.563398344910375,34.1499136729282,1624.2859474697852,6,9745.715684818711,301572.98121841415,291827.26553359546
403,1961,1982,21,61,60,2022,2021,18332.578712477836,0.04757243187756326,55.929918060976135,37.31653271807781,0.0,0,0.0,367418.82589308464,367418.82589308464
404,1954,1982,28,59,70,2013,2024,20943.946574335885,0.02432304205795736,29.28317187884874,28.600015068183232,837.4991569792735,11,9212.490726772008,177204.21553916312,167991.72481239113
405,1960,1982,22,60,60,2020,2020,23794.012713079603,0.007908189775273789,31.464838479025573,35.17441108311604,1106.7571633250932,0,0.0,195286.06218444934,195286.06218444934
406,1955,1983,28,59,66,2014,2021,18920.651447105167,0.026516858875446064,27.085132260963018,29.45801552022873,797.8742465108965,7,5585.119725576275,166010.6710572297,160425.5513316534
407,1957,1983,26,60,63,2017,2020,13641.548182672866,0.02016375737837978,19.673813298636826,32.18956892537298,633.2915692013897,3,1899.874707604169,122238.03025591055,120338.15554830639
408,1963,1983,20,64,70,2027,2033,28541.55022861558,0.0366594813006732,82.39873121991658,43.26008892283532,3564.5764397023986,0,0.0,561170.1524328477,561170.1524328477
409,1958,1983,25,58,63,2016,2021,28456.583146930327,0.020312681039330583,39.74213857573353,31.25200866541066,1242.0216591507753,5,6210.1082957538765,245399.98343943115,239189.87514367726
410,1962,1983,21,61,70,2023,2032,35440.47655748204,0.04121587348383306,97.04061071488647,38.43602869962015,3729.855698466043,2,7459.711396932086,644661.8248614145,637202.1134644824
411,1961,1983,22,61,61,2022,2022,21032.78052631869,0.025706487626446353,39.81404079655549,37.31653271807781,1485.7219560235476,0,0.0,257329.92089952328,257329.92089952328
412,1959,1983,24,62,64,2021,2023,38914.66826447053,0.017429012885747105,60.68228777584015,36.22964341560952,2198.4976477620894,2,4396.995295524179,385482.07031654235,381085.07502101816
413,1955,1983,28,62,64,2017,2019,33710.132075804446,0.03410741148899862,62.08502255649492,32.18956892537298,1998.4901128156296,2,3996.980225631259,391151.83569975523,387154.85547412396
414,1959,1983,24,67,66,2026,2025,26059.30394357775,0.015760093600861877,43.94627662002739,42.00008633284983,0.0,0,0.0,285572.61253591377,285572.61253591377
415,1961,1983,22,67,60,2028,2021,28878.964180322084,0.014942813888764797,42.97540246435966,44.557891590520384,0.0,0,0.0,272130.1387632712,272130.1387632712
416,1961,1983,22,61,59,2022,2020,13292.085960325105,0.03239797444868465,26.761736312905356,37.31653271807781,0.0,0,0.0,171963.5563866096,171963.5563866096
417,1961,1983,22,61,65,2022,2026,14477.133338505284,0.01135998813437248,20.69544615120732,37.31653271807781,772.2822934167455,3,2316.8468802502366,131212.04029628448,128895.19341603425
418,1964,1983,19,61,70,2025,2034,29551.31943732905,0.04553429639931331,97.60250276864463,40.77678284742702,3979.9160607624167,0,0.0,662643.6500702589,662643.6500702589
419,1962,1983,21,63,68,2025,2030,33550.49631511171,0.04960423444701172,122.36824757547542,40.77678284742702,4989.783458805349,0,0.0,835293.45265556,835293.45265556
420,1958,1984,26,58,66,2016,2024,19462.20687244038,0.039406735304327103,35.598558801777756,31.25200866541066,1112.5264681492893,8,8900.211745194314,224563.74482349295,215663.53307829864
421,1966,1984,18,67,60,2033,2026,11152.790468869749,0.05008809960677118,40.716506791897956,51.654808526360284,0.0,0,0.0,281168.63295404456,281168.63295404456
422,1962,1984,22,64,60,2026,2022,21590.467295449467,0.027506221620987984,40.49710891836652,42.00008633284983,0.0,0,0.0,263408.3333940951,263408.3333940951
423,1966,1984,18,58,70,2024,2036,23518.589701892735,0.04912297202280499,76.26346065655913,39.589109560608755,3019.2024994036947,1,3019.2024994036947,517259.8429010022,514240.64040159853
424,1962,1984,22,58,65,2020,2027,30406.8333762506,0.007083645030119214,36.860716091442875,35.17441108311604,1296.553980618442,5,6482.76990309221,230993.9482672328,224511.1783641406
425,1958,1984,26,64,69,2022,2027,29771.066026110424,0.045106527906379375,80.3453301518314,37.31653271807781,2998.20914135558,3,8994.62742406674,533637.8665279781,524643.2391039113
426,1964,1984,20,65,59,2029,2023,38695.041948984406,0.04187541797295034,101.85790839096545,45.894628338236,0.0,0,0.0,679313.4121798058,679313.4121798058
427,1957,1984,27,61,69,2018,2026,39122.4987301201,0.05211576948365964,99.70406403405055,33.15525599313417,3305.7137666047875,7,23139.996366233514,645844.1227099617,622704.1263437282
428,1964,1984,20,60,69,2024,2033,22363.927907883146,0.03248080218594623,49.981591374947286,39.589109560608755,1978.7266969563657,1,1978.7266969563657,331887.11805734003,329908.39136038366
429,1961,1984,23,65,68,2026,2029,10628.348830927385,0.009108583373821368,15.47357113875138,42.00008633284983,649.8913237050515,0,0.0,100594.61944106559,100594.61944106559
430,1966,1984,18,65,66,2031,2032,28739.907065627915,0.0240969819826448,66.40277749558298,48.68961120403458,3233.1254191279522,0,0.0,457470.11151036597,457470.11151036597
431,1965,1984,19,60,59,2025,2024,17662.404540556585,0.018035664995995827,29.219090767456258,40.77678284742702,0.0,0,0.0,190198.51671817165,190198.51671817165
432,1958,1984,26,66,67,2024,2025,25909.06399747475,0.0070975611715818135,34.643943989105644,39.589109560608755,1371.5228941962964,1,1371.5228941962964,222006.72698833907,220635.20409414277
433,1965,1984,19,67,63,2032,2028,13757.007112984815,0.028716805495310697,32.4443397132637,50.15029954015561,0.0,0,0.0,220578.36565755997,220578.36565755997
434,1966,1985,19,63,63,2029,2029,37608.91543658223,0.03103840709171064,92.7025864292801,45.894628338236,4254.55075016501,0,0.0,639588.552390628,639588.552390628
435,1966,1985,19,67,59,2033,2025,37842.50920978149,0.016230780592192597,59.73069747994097,51.654808526360284,0.0,0,0.0,392083.40776647767,392083.40776647767
436,1959,1985,26,65,69,2024,2028,26502.75821374468,0.024432639931492355,47.83369161400244,39.589109560608755,1893.693257995115,1,1893.693257995115,315474.00760746235,313580.3143494672
437,1966,1985,19,63,62,2029,2028,17220.781354975148,0.011075068815045903,26.41696013605931,45.894628338236,0.0,0,0.0,175200.31970143173,175200.31970143173
438,1965,1985,20,58,66,2023,2031,39772.462014684104,0.03857274674473216,92.46559378655162,38.43602869962015,3554.010216507317,2,7108.020433014634,616227.056053079,609119.0356200644
439,1961,1985,24,64,59,2025,2020,17752.948608754545,0.03220082895913758,32.1915943334343,40.77678284742702,0.0,0,0.0,208385.18475270597,208385.18475270597
440,1963,1985,22,62,66,2025,2029,32445.757179369924,0.0328906612755535,72.3621674983622,40.77678284742702,2950.6963904498566,0,0.0,486049.4378448303,486049.4378448303
441,1961,1985,24,63,64,2024,2025,39540.09218573525,0.05186940332485595,128.57482775616853,39.589109560608755,5090.162942775355,1,5090.162942775355,877156.348832302,872066.1858895266
442,1966,1985,19,59,63,2025,2029,31779.397299558867,0.045889266492847254,94.62869377304473,40.77678284742702,3858.6536971191144,0,0.0,646322.7290666708,646322.7290666708
443,1965,1985,20,64,66,2029,2031,20271.509081006392,0.025670822464763075,44.03404799991868,45.894628338236,2020.9262671843119,0,0.0,301155.4891535531,301155.4891535531
444,1963,1985,22,58,66,2021,2029,28358.21516011993,0.010296535627924649,35.92417650489299,36.22964341560952,1301.5201047716907,4,5206.080419086763,228457.67349816716,223251.5930790804
445,1961,1985,24,64,70,2025,2031,29088.74061937744,0.0430560768521579,81.2188120215993,40.77678284742702,3311.84186093075,0,0.0,552775.4550707301,552775.4550707301
446,1960,1985,25,67,68,2027,2028,10279.948594812799,0.01733394322608115,17.52959452883473,43.26008892283532,758.3318180986379,0,0.0,116717.8047078611,116717.8047078611
447,1963,1985,22,60,59,2023,2022,18337.062917466035,0.014697693363388744,25.827649488354577,38.43602869962015,0.0,0,0.0,166097.01999244155,166097.01999244155
448,1959,1986,27,59,69,2018,2028,19327.867900226625,0.04211740252862546,36.24202630610143,33.15525599313417,1201.6136598886956,7,8411.29561922087,234215.2664501112,225803.97083089032
449,1962,1986,24,59,67,2021,2029,21257.79713327999,0.031934783367151956,37.94044471619409,36.22964341560952,1374.5687830973582,4,5498.275132389433,248232.1965975154,242733.92146512598
450,1965,1986,21,63,68,2028,2033,32829.722800842814,0.006765567747011954,44.631753532185364,44.557891590520384,1988.6968353819407,0,0.0,295467.8214303031,295467.8214303031
451,1968,1986,18,66,60,2034,2028,32760.291703330146,0.03891894114275709,89.42849467145238,53.204452782151094,0.0,0,0.0,621701.9329117563,621701.9329117563
452,1966,1986,20,64,64,2030,2030,36299.522854846015,0.054816716881362366,161.33742017672952,47.271467188383085,7626.656564142645,0,0.0,1165938.3003060422,1165938.3003060422
453,1965,1986,21,61,62,2026,2027,33411.99328441823,0.01586045488456053,51.781817685912664,42.00008633284983,2174.8408132802224,0,0.0,343463.6308584526,343463.6308584526
454,1959,1986,27,62,64,2021,2023,22378.655225458715,0.03978090732484034,46.27966013250184,36.22964341560952,1676.6955839961417,2,3353.3911679922835,305227.1401597469,301873.74899175466
455,1964,1986,22,67,64,2031,2028,15006.553535646128,0.014065963996275261,23.64363735271339,48.68961120403458,0.0,0,0.0,158345.95388139493,158345.95388139493
456,1965,1986,21,58,65,2023,2030,36227.87411830713,0.03050548562494126,68.00874092410956,38.43602869962015,2613.9859179841064,2,5227.971835968213,450598.6177343107,445370.6458983425
457,1966,1986,20,65,63,2031,2029,27399.513622843937,0.03307422939797618,67.7052352785564,48.68961120403458,0.0,0,0.0,470253.84861739347,470253.84861739347
458,1965,1986,21,65,66,2030,2031,30294.038116790867,0.04524944998403849,104.95730159222809,47.271467188383085,4961.485638398238,0,0.0,748314.6551243118,748314.6551243118
459,1966,1986,20,58,61,2024,2027,11756.527877319375,0.021711915934803042,19.256286905078724,39.589109560608755,762.3392520156773,1,762.3392520156773,127096.38291950406,126334.04366748838
460,1959,1986,27,63,63,2022,2022,33658.448940172195,0.03086345282208047,61.240632104923804,37.31653271807781,2285.2880516191553,0,0.0,403059.62780237873,403059.62780237873
461,1965,1986,21,64,59,2029,2024,23020.580985216257,0.009430021483980863,29.950881026614088,45.894628338236,0.0,0,0.0,194590.08325823108,194590.08325823108
462,1966,1987,21,58,69,2024,2035,34041.00747458557,0.04332942619858217,81.79126490857091,39.589109560608755,3238.043347566188,1,3238.043347566188,555854.8697081585,552616.8263605924
463,1961,1987,26,63,59,2024,2020,22637.44159882216,0.036808868235411636,40.09800551149459,39.589109560608755,0.0,0,0.0,262700.07458485826,262700.07458485826
464,1959,1987,28,63,70,2022,2029,21514.98855799132,0.03359361356135933,39.168261204642945,37.31653271807781,1461.6237007532761,3,4384.871102259828,259529.129031648,255144.25792938817
465,1965,1987,22,66,62,2031,2027,20867.06324956865,0.021725564437096608,35.99907168373141,48.68961120403458,0.0,0,0.0,243409.3503128757,243409.3503128757
466,1959,1987,28,58,64,2017,2023,18192.124299184372,0.030903938311940774,25.59319574033366,32.18956892537298,823.8339383040325,6,4943.003629824195,163360.81327467633,158417.80964485212
467,1967,1987,20,62,61,2029,2028,17778.902765973213,0.026482840636946756,34.984932223470295,45.894628338236,0.0,0,0.0,239778.48627409956,239778.48627409956
468,1967,1987,20,62,63,2029,2030,24427.18002259209,0.026759019962767843,49.95928621658577,45.894628338236,2292.86287295376,0,0.0,344955.89289093704,344955.89289093704
469,1965,1987,22,61,64,2026,2029,28935.11937870119,0.007492101389147078,36.84031955332742,42.00008633284983,1547.2966017695273,0,0.0,242731.1577120719,242731.1577120719
470,1963,1987,24,59,61,2022,2024,23105.521078455386,0.04147541143261983,48.819315237719856,37.31653271807781,1821.7675743425275,2,3643.535148685055,326069.84371862654,322426.3085699415
471,1964,1987,23,66,64,2030,2028,16756.711068054694,0.011567470407245335,24.21241275918849,47.271467188383085,0.0,0,0.0,162329.14036378113,162329.14036378113
472,1961,1987,26,61,66,2022,2027,24161.81302590995,0.005670131321608281,26.975706760747652,37.31653271807781,1006.6398439307126,3,3019.9195317921376,173445.38055201372,170425.46102022158
473,1962,1987,25,67,64,2029,2026,17851.17051207718,0.01734893995359999,27.393494019280958,45.894628338236,0.0,0,0.0,182927.94798239827,182927.94798239827
474,1962,1987,25,67,64,2029,2026,22866.606365831158,0.04723947181430107,65.56070402808142,45.894628338236,0.0,0,0.0,454723.5192534889,454723.5192534889
475,1964,1987,23,66,62,2030,2026,11008.408005498479,0.008132660172767727,14.18263408129056,47.271467188383085,0.0,0,0.0,93527.88189159293,93527.88189159293
476,1961,1988,27,66,63,2027,2024,25972.620468256515,0.02555478013003533,41.84669341167326,43.26008892283532,0.0,0,0.0,279853.7987055702,279853.7987055702
477,1964,1988,24,63,60,2027,2024,31973.461955142695,0.032416029186321214,58.62513289313026,43.26008892283532,0.0,0,0.0,395052.7588875317,395052.7588875317
478,1963,1988,25,64,63,2027,2026,11567.736378580714,0.02593966595370807,20.133731869472587,43.26008892283532,0.0,0,0.0,136549.4842903672,136549.4842903672
479,1962,1988,26,62,68,2024,2030,39386.52521145271,0.012248253618990852,49.945282195110835,39.589109560608755,1977.2892488577645,1,1977.2892488577645,328967.9978938765,326990.70864501875
480,1964,1988,24,67,63,2031,2027,26959.9076371483,0.028196624334416814,50.83767550884142,48.68961120403458,0.0,0,0.0,348181.3671019212,348181.3671019212
481,1962,1988,26,62,70,2024,2032,20485.191162604562,0.010704789244396669,25.290398650689855,39.589109560608755,1001.2243630136325,1,1001.2243630136325,166277.98510793244,165276.7607449188
482,1969,1988,19,62,62,2031,2031,22539.69801611453,0.00944201225437822,32.34904184037701,48.68961120403458,1575.062270031004,0,0.0,221099.49755138648,221099.49755138648
483,1965,1988,23,64,59,2029,2024,25701.727341230995,0.010738443593460874,31.749040242973656,45.894628338236,0.0,0,0.0,208750.10911810162,208750.10911810162
484,1969,1988,19,67,69,2036,2038,12030.050857000047,0.04039175486148843,42.18081543224234,56.444603956584096,2380.8794216386896,0,0.0,315231.4505144524,315231.4505144524
485,1970,1988,18,59,64,2029,2034,16784.411547698222,0.04734593640442799,52.382013891527514,45.894628338236,2404.0530591599704,0,0.0,373434.12357475987,373434.12357475987
486,1961,1988,27,62,63,2023,2024,38370.944410008466,0.047498768574033096,90.12611856092424,38.43602869962015,3464.0900795930525,1,3464.0900795930525,612184.7012778484,608720.6111982554
487,1969,1988,19,67,60,2036,2029,35859.60725212817,0.028008113224421986,72.13671495298063,56.444603956584096,0.0,0,0.0,500941.1371091683,500941.1371091683
488,1964,1988,24,63,70,2027,2034,11868.193176456569,0.030625132438516587,23.53104410759389,43.26008892283532,1017.9550605416717,0,0.0,161667.25479534178,161667.25479534178
489,1960,1988,28,67,61,2027,2021,11558.697326628053,0.044313909969201655,23.154289570833853,43.26008892283532,0.0,0,0.0,154395.94096072036,154395.94096072036
490,1965,1989,24,62,62,2027,2027,26345.43277253547,0.042921250893455554,64.24960738920598,43.26008892283532,2779.443728914308,0,0.0,449603.66488310933,449603.66488310933
491,1968,1989,21,63,66,2031,2034,13787.613483778405,0.03798146831973711,35.62993409263408,48.68961120403458,1734.8076381957299,0,0.0,255622.39234791204,255622.39234791204
492,1968,1989,21,66,66,2034,2034,39549.68968422625,0.04360062381549952,132.60125205716736,53.204452782151094,7054.977053929676,0,0.0,982633.4015560804,982633.4015560804
493,1970,1989,19,66,66,2036,2036,23917.941304369982,0.05046101029307801,105.4471690651174,56.444603956584096,5951.923696223517,0,0.0,803372.0219585777,803372.0219585777
494,1971,1989,18,67,62,2038,2033,33950.32564672985,0.023596633395843246,67.29025305630796,59.88208033754007,0.0,0,0.0,479138.87509184843,479138.87509184843
495,1965,1989,24,66,69,2031,2034,21412.60022522687,0.04378059254626637,63.48905920704803,48.68961120403458,3091.2576085011005,0,0.0,459188.0077706857,459188.0077706857
496,1969,1989,20,65,70,2034,2039,25699.88893584224,0.019356897904228777,47.528583549757954,53.204452782151094,2528.7322792756204,0,0.0,338231.5954181248,338231.5954181248
497,1963,1989,26,61,63,2024,2026,29037.47252650911,0.0448957079807947,64.12119640005474,39.589109560608755,2538.501069439079,1,2538.501069439079,439225.30889279424,436686.8078233552
498,1964,1989,25,59,68,2023,2032,23428.08820960651,0.03289100959646007,39.53205524670401,38.43602869962015,1519.4552100172848,2,3038.9104200345696,265643.7509946143,262604.8405745798
499,1970,1989,19,64,61,2034,2031,20893.022099020312,0.04985931704823095,71.8104334251878,53.204452782151094,0.0,0,0.0,523612.3076516319,523612.3076516319
500,1961,1989,28,65,64,2026,2025,14221.345841462753,0.0151007834201245,18.753045369192037,42.00008633284983,0.0,0,0.0,125290.42337188999,125290.42337188999
501,1964,1989,25,62,70,2026,2034,34611.325223469205,0.02065809974086412,52.078598849913334,42.00008633284983,2187.305647790214,0,0.0,352435.1284101271,352435.1284101271
502,1966,1989,23,63,61,2029,2027,36472.49105222016,0.04518017677207676,93.33857660146577,45.894628338236,0.0,0,0.0,654846.0144798539,654846.0144798539
503,1965,1989,24,58,65,2023,2030,13673.016950768231,0.04125927740136954,26.87680621424698,38.43602869962015,1033.0376950049263,2,2066.0753900098525,182062.22242704814,179996.1470370383
504,1971,1990,19,61,70,2032,2041,36457.83274913932,0.02637448439603076,71.54554944123149,50.15029954015561,3588.0307352427717,0,0.0,510189.8326507889,510189.8326507889
505,1966,1990,24,62,67,2028,2033,12790.914593800815,0.006468207955119616,15.102374741798986,44.557891590520384,672.9299765044925,0,0.0,102113.73620865145,102113.73620865145
506,1969,1990,21,59,68,2028,2037,12382.197539290886,0.04157482451701812,29.02840837990027,44.557891590520384,1293.4446736369498,0,0.0,205050.1101590361,205050.1101590361
507,1964,1990,26,61,64,2025,2028,26223.81264956633,0.04051213993116558,52.639109786472076,40.77678284742702,2146.4535490448425,0,0.0,362964.35466848436,362964.35466848436
508,1964,1990,26,59,70,2023,2034,23777.955915196417,0.022889913266272092,32.10323142270029,38.43602869962015,1233.9207243134558,2,2467.8414486269116,214536.63503449253,212068.7935858656
509,1971,1990,19,63,61,2034,2032,36394.65741855086,0.031271745627284644,79.70165922260357,53.204452782151094,0.0,0,0.0,572515.9375956393,572515.9375956393
510,1968,1990,22,65,68,2033,2036,13019.124355706,0.016993705637797236,21.431655151863204,51.654808526360284,1107.0480432724767,0,0.0,151600.6700592309,151600.6700592309
511,1969,1990,21,59,67,2028,2036,32190.139021802912,0.014563020895729337,44.057884709719765,44.557891590520384,1963.126450603339,0,0.0,301041.26809313806,301041.26809313806
512,1962,1990,28,66,65,2028,2027,28627.857024352936,0.022618747330482723,44.20517757824621,44.557891590520384,0.0,0,0.0,303155.2818554215,303155.2818554215
513,1968,1990,22,60,59,2028,2027,13787.942246935083,0.0388088781037717,29.22985172858045,44.557891590520384,0.0,0,0.0,204252.15258850995,204252.15258850995
514,1971,1990,19,60,66,2031,2037,10114.514023730415,0.039083474120081,25.481768141619806,48.68961120403458,1240.697383606823,0,0.0,183674.88752532806,183674.88752532806
515,1967,1990,23,66,62,2033,2029,16815.386710705447,0.046852056262147,46.25410860918804,51.654808526360284,0.0,0,0.0,331367.7751012733,331367.7751012733
516,1966,1990,24,60,62,2026,2028,35991.59542754026,0.015776493439566594,47.50890651904398,42.00008633284983,1995.3781753791395,0,0.0,321152.34699341806,321152.34699341806
517,1968,1990,22,60,67,2028,2035,19118.392037221714,0.03765813952656415,41.287350569326286,44.557891590520384,1839.6772907278507,0,0.0,290312.224026124,290312.224026124
518,1970,1991,21,58,65,2028,2035,34221.88091019854,0.007954694503912663,40.024463606234775,44.557891590520384,1783.4057103353377,0,0.0,272589.85485603684,272589.85485603684
519,1972,1991,19,60,59,2032,2031,36226.801724150544,0.005009419977829095,43.14781090180916,50.15029954015561,0.0,0,0.0,297606.73188607284,297606.73188607284
520,1963,1991,28,59,66,2022,2029,21385.08710124156,0.016336519146175534,23.956698129669338,37.31653271807781,893.9809095729192,3,2681.9427287187577,158891.49560279294,156209.55287407417
521,1969,1991,22,65,61,2034,2030,22382.833877980782,0.04511771645796321,58.60167202757658,53.204452782151094,0.0,0,0.0,423576.4441616775,423576.4441616775
522,1963,1991,28,61,59,2024,2022,11260.740255142158,0.041995206038346514,18.991146180645217,39.589109560608755,0.0,0,0.0,128657.90913849729,128657.90913849729
523,1964,1991,27,63,65,2027,2029,13823.61878268607,0.04038441631653093,28.63624451289704,43.26008892283532,1238.806484043981,0,0.0,201120.51388396102,201120.51388396102
524,1971,1991,20,60,68,2031,2039,30979.46125378611,0.04697304547503835,88.55580842042549,48.68961120403458,4311.747881849488,0,0.0,646740.5983141112,646740.5983141112
525,1967,1991,24,66,69,2033,2036,28847.143313898443,0.031633794338077746,63.00133847162951,51.654808526360284,3254.3220756564383,0,0.0,457775.51219658257,457775.51219658257
526,1971,1991,20,61,66,2032,2037,31110.579323823873,0.032034923832245515,66.15302340874572,50.15029954015561,3317.5939394355237,0,0.0,477429.9354335604,477429.9354335604
527,1966,1991,25,58,67,2024,2033,10372.121088319444,0.028438398273225293,15.210224886816007,39.589109560608755,602.1592594856568,1,602.1592594856568,103304.47406343269,102702.31480394703
528,1965,1991,26,62,61,2027,2026,16790.54483024458,0.0415123073545073,33.98157045476195,43.26008892283532,0.0,0,0.0,237128.06229234402,237128.06229234402
529,1965,1991,26,61,69,2026,2034,37086.84985575962,0.04761319371955907,84.4867695900568,42.00008633284983,3548.451616765977,0,0.0,593091.7122523941,593091.7122523941
530,1965,1991,26,63,67,2028,2032,39670.85075050521,0.03630880857965691,79.09779590469692,44.557891590520384,3524.4310149705925,0,0.0,557230.3607630726,557230.3607630726
531,1973,1991,18,60,69,2033,2042,39863.1254857393,0.04778480469187697,127.40448070306331,51.654808526360284,6581.054056117099,0,0.0,946938.5536369045,946938.5536369045
532,1970,1992,22,62,62,2032,2032,16606.759041319452,0.02941873144914694,31.846349838265994,50.15029954015561,1597.1039836496257,0,0.0,229858.53910617932,229858.53910617932
533,1970,1992,22,66,67,2036,2037,30076.007888142354,0.04646433996583778,100.66429096202198,56.444603956584096,5681.956035921678,0,0.0,767757.9755843065,767757.9755843065
534,1967,1992,25,58,66,2025,2033,25523.39055265124,0.02652137051604951,35.83508386950649,40.77678284742702,1461.239433266201,0,0.0,245617.81332879813,245617.81332879813
535,1969,1992,23,66,61,2035,2030,36775.698698645385,0.027169000718959387,62.77739088171888,54.80058636561562,0.0,0,0.0,445488.68406652886,445488.68406652886
536,1967,1992,25,62,61,2029,2028,23357.383368543648,0.04444011319526798,51.88072985341141,45.894628338236,0.0,0,0.0,369942.15041762445,369942.15041762445
537,1972,1992,20,61,65,2033,2037,25370.91332637372,0.010211240140417384,33.78978159957322,51.654808526360284,1745.4046986734866,0,0.0,238786.6759400783,238786.6759400783
538,1969,1992,23,60,64,2029,2033,17880.269277959553,0.018578438237551995,25.047328782547652,45.894628338236,1149.5378453406256,0,0.0,174721.10343752924,174721.10343752924
539,1964,1992,28,64,67,2028,2031,25187.981784856085,0.03670520156881656,48.019461497923956,44.557891590520384,2139.6459596596633,0,0.0,339633.2341734696,339633.2341734696
540,1969,1992,23,63,67,2032,2036,10087.63097864086,0.006988298249428477,12.332789283433993,50.15029954015561,618.4930767298358,0,0.0,86246.35319487227,86246.35319487227
541,1969,1992,23,67,69,2036,2038,14200.72292659953,0.01884071538956529,24.457522019652068,56.444603956584096,1380.4951441586957,0,0.0,178522.3665711228,178522.3665711228
542,1974,1992,18,66,59,2040,2033,28675.590871892357,0.02848718814953419,55.793147512360946,63.52889903009626,0.0,0,0.0,405053.9580996557,405053.9580996557
543,1971,1992,21,65,59,2036,2030,25497.178853379373,0.005275289958021041,28.834986195835242,56.444603956584096,0.0,0,0.0,198968.31261409537,198968.31261409537
544,1974,1992,18,65,69,2039,2043,35317.73837835172,0.019245401076548044,66.41782700789258,61.67854274766627,4096.554782313406,0,0.0,494809.63786373276,494809.63786373276
545,1968,1992,24,62,63,2030,2031,27161.459301079027,0.030633386297820822,49.69483020803592,47.271467188383085,2349.1475356114383,0,0.0,354156.80744479725,354156.80744479725
546,1965,1993,28,63,67,2028,2032,21910.45123711575,0.009354638339788574,24.346006212999825,44.557891590520384,1084.806705500982,0,0.0,167839.89214837833,167839.89214837833
547,1967,1993,26,58,66,2025,2033,25947.983938132926,0.048993133868058,50.835655416064554,40.77678284742702,2072.9144818074915,0,0.0,356693.69655405363,356693.69655405363
548,1969,1993,24,66,65,2035,2034,24806.39741020356,0.04011293830158321,61.92127945806948,54.80058636561562,0.0,0,0.0,461864.49310681666,461864.49310681666
549,1973,1993,20,58,66,2031,2039,22654.84535616494,0.02555105376327729,37.0469326307717,48.68961120403458,1803.8007460943359,0,0.0,265255.0042198574,265255.0042198574
550,1968,1993,25,62,70,2030,2038,30238.235587486484,0.0198363820552045,42.88785965873642,47.271467188383085,2027.372050637937,0,0.0,302920.88179649325,302920.88179649325
551,1966,1993,27,64,70,2030,2036,34635.9484765068,0.005078255259573645,37.69942180069677,47.271467188383085,1782.1069806726512,0,0.0,261501.70378754096,261501.70378754096
552,1965,1993,28,64,65,2029,2030,11216.762126340444,0.04857988636441153,26.791878421440607,45.894628338236,1229.6033026352216,0,0.0,193961.36355304555,193961.36355304555
553,1974,1993,19,59,62,2033,2036,21515.166491349384,0.027811825447777102,39.444746944683565,51.654808526360284,2037.5108507983643,0,0.0,287205.39556965296,287205.39556965296
554,1974,1993,19,62,61,2036,2035,27889.64556581105,0.03247918283610718,60.749752046559095,56.444603956584096,0.0,0,0.0,451739.67860689847,451739.67860689847
555,1975,1993,18,58,70,2033,2045,12405.400422457104,0.022738564591799213,20.46244962236493,51.654808526360284,1056.9839172235538,0,0.0,147953.06374981292,147953.06374981292
556,1969,1993,24,59,67,2028,2036,29393.50270373821,0.04940195321800589,67.85693845316626,44.557891590520384,3023.5621072607964,0,0.0,487724.1724684468,487724.1724684468
557,1966,1993,27,59,61,2025,2027,37398.6084272871,0.03562867341724096,58.12618856443638,40.77678284742702,2370.1989688406184,0,0.0,403307.8496342819,403307.8496342819
558,1973,1993,20,61,64,2034,2037,13616.752492110707,0.050122665364292086,42.98128446518888,53.204452782151094,2286.795719844346,0,0.0,324782.68404462445,324782.68404462445
559,1970,1993,23,60,66,2030,2036,34600.37887358068,0.03974411868379796,72.34315668456549,47.271467188383085,3419.7671575184936,0,0.0,522930.1850273497,522930.1850273497
560,1974,1994,20,58,65,2032,2039,27315.996602036525,0.007186953615447368,31.27069392351314,50.15029954015561,1568.2346670927077,0,0.0,221099.91320206804,221099.91320206804
561,1972,1994,22,58,67,2030,2039,31875.20462648344,0.037614582429596984,60.516478605734676,47.271467188383085,2860.7027327674737,0,0.0,437916.6769814223,437916.6769814223
562,1972,1994,22,63,69,2035,2041,22897.932321704444,0.038648331119721616,54.671308776372975,54.80058636561562,2996.0197783208664,0,0.0,411461.4688325304,411461.4688325304
563,1970,1994,24,66,63,2036,2033,35852.27484754886,0.034514277147657986,72.22215799255527,56.444603956584096,0.0,0,0.0,532484.1074070655,532484.1074070655
564,1975,1994,19,60,61,2035,2036,35726.87012983851,0.050831761792060365,113.45505560274412,54.80058636561562,6217.403573173902,0,0.0,867507.5763562378,867507.5763562378
565,1970,1994,24,65,69,2035,2039,27465.962397823416,0.02355862117188138,47.02808227783663,54.80058636561562,2577.166484475864,0,0.0,346502.2455906168,346502.2455906168
566,1968,1994,26,63,62,2031,2030,21789.22676035874,0.03129062994366619,36.61892282925268,48.68961120403458,0.0,0,0.0,263177.2406511245,263177.2406511245
567,1975,1994,19,65,70,2040,2045,22915.880153866226,0.012129707204095438,34.89624996410976,63.52889903009626,2216.920340498929,0,0.0,260477.6245637509,260477.6245637509
568,1969,1994,25,58,59,2027,2028,38399.33301980639,0.021988441357555896,48.88515382539312,43.26008892283532,2114.7761014929897,0,0.0,341004.7502807489,341004.7502807489
569,1967,1994,27,59,70,2026,2037,10201.3117091218,0.0242937251447558,12.996346747537892,42.00008633284983,545.8476854082436,0,0.0,90263.59576690856,90263.59576690856
570,1966,1994,28,58,59,2024,2025,30313.619192050282,0.035288962472634515,42.29747585957008,39.589109560608755,1674.5194059417238,1,1674.5194059417238,292453.8816179005,290779.3622119588
571,1975,1994,19,61,66,2036,2041,39641.07898466775,0.027700081059805745,76.68501171516478,56.444603956584096,4328.455115668487,0,0.0,572439.9023995687,572439.9023995687
572,1973,1994,21,58,60,2031,2033,24567.690989781935,0.006376835993473275,27.050812983486562,48.68961120403458,1317.0935669190112,0,0.0,190007.24948662266,190007.24948662266
573,1966,1994,28,60,69,2026,2035,14073.671411918114,0.009965110137684648,14.308905738380746,42.00008633284983,600.9752763406017,0,0.0,98092.92558857748,98092.92558857748
574,1972,1995,23,67,61,2039,2033,10700.562889845578,0.04281068069750884,24.38063452503115,61.67854274766627,0.0,0,0.0,182161.32157176535,182161.32157176535
575,1973,1995,22,67,63,2040,2036,35064.407091469824,0.023519849313765325,59.33630514877821,63.52889903009626,0.0,0,0.0,441973.1824509304,441973.1824509304
576,1973,1995,22,60,65,2033,2038,23323.83139497255,0.054742898652966075,68.85693502124991,51.654808526360284,3556.7917942346958,0,0.0,521312.35629374697,521312.35629374697
577,1969,1995,26,58,69,2027,2038,38834.06456222779,0.02447409474512102,49.079227046406345,43.26008892283532,2123.1717262915627,0,0.0,344675.36500705744,344675.36500705744
578,1972,1995,23,61,63,2033,2035,14624.351295354612,0.03268557426790056,26.99257999074574,51.654808526360284,1394.296551054435,0,0.0,199280.96922170356,199280.96922170356
579,1976,1995,19,63,63,2039,2039,35009.49885812757,0.027022067515621206,70.34753961291403,61.67854274766627,4338.933729208265,0,0.0,537935.9665574091,537935.9665574091
580,1968,1995,27,59,61,2027,2029,15315.127758155966,0.03037231830598711,21.323506988455783,43.26008892283532,922.4568084672976,0,0.0,150536.07384409872,150536.07384409872
581,1973,1995,22,64,62,2037,2035,20418.31117091523,0.0340233800496848,41.83308673407775,58.13794207528162,0.0,0,0.0,313945.25643925567,313945.25643925567
582,1970,1995,25,60,60,2030,2030,24666.93495377354,0.025088940032716216,35.218143528173655,47.271467188383085,1664.813316227827,0,0.0,252439.93980954628,252439.93980954628
583,1977,1995,18,60,70,2037,2047,19014.681568012973,0.021291155878222494,31.618833052366934,58.13794207528162,1838.253884486509,0,0.0,236312.1368529923,236312.1368529923
584,1970,1995,25,67,61,2037,2031,16039.363234672997,0.024756887163215932,23.58598438912604,58.13794207528162,0.0,0,0.0,170134.68116495622,170134.68116495622
585,1973,1995,22,58,63,2031,2036,26290.737518729897,0.01638748680516048,33.21485081150124,48.68961120403458,1617.2181722120079,0,0.0,237317.6760122455,237317.6760122455
586,1967,1995,28,62,60,2029,2027,31664.297063677175,0.03166933143826813,45.04882364903571,45.894628338236,0.0,0,0.0,318389.471786269,318389.471786269
587,1972,1995,23,62,64,2034,2036,33715.29382824655,0.011241040698342416,42.172839132762164,53.204452782151094,2243.7828283282984,0,0.0,304842.1734084231,304842.1734084231
588,1978,1996,18,65,62,2043,2040,24003.46231693564,0.006723062971250001,30.492476276407707,69.41974325046002,0.0,0,0.0,227706.71949092727,227706.71949092727
589,1973,1996,23,58,61,2031,2034,23880.268151961805,0.054049368908134256,58.5122523620726,48.68961120403458,2848.938818181669,0,0.0,436495.3253127548,436495.3253127548
590,1975,1996,21,63,65,2038,2040,21259.897237588055,0.01928917777629351,33.50080667489292,59.88208033754007,2006.0979966783364,0,0.0,252350.13902099113,252350.13902099113
591,1978,1996,18,65,65,2043,2043,21596.215204690838,0.03056377311003756,51.51354542949835,69.41974325046002,3576.0570976366835,0,0.0,409579.9408213678,409579.9408213678
592,1970,1996,26,60,60,2030,2030,31771.493896598473,0.04972262784121161,67.82789538728942,47.271467188383085,3206.324131257332,0,0.0,499923.95637719147,499923.95637719147
593,1968,1996,28,59,70,2027,2038,34825.5676631891,0.04322638973273588,56.76278142921003,43.26008892283532,2455.5629721350915,0,0.0,406561.6579850592,406561.6579850592
594,1975,1996,21,64,61,2039,2036,16014.235465852084,0.010463210515481072,20.021571719072355,61.67854274766627,0.0,0,0.0,147014.24559807763,147014.24559807763
595,1975,1996,21,58,59,2033,2034,35409.065626211814,0.049654510259770746,87.97488080274962,51.654808526360284,4544.325622995401,0,0.0,664226.5466657466,664226.5466657466
596,1976,1996,20,63,61,2039,2037,23449.571661082664,0.03052162445021161,45.658595678414954,61.67854274766627,0.0,0,0.0,347306.84730461903,347306.84730461903
597,1972,1996,24,59,64,2031,2036,30631.66127291682,0.041135347884911425,58.271355575077536,48.68961120403458,2837.209647282578,0,0.0,429326.2976650303,429326.2976650303
598,1973,1996,23,67,68,2040,2041,28976.323298974836,0.03722351385605168,73.5776330182824,63.52889903009626,4674.306018891939,0,0.0,578183.466766373,578183.466766373
599,1977,1996,19,66,66,2043,2043,31991.5356957998,0.031428905486109854,78.02895582037175,69.41974325046002,5416.750079151694,0,0.0,621380.7755190657,621380.7755190657
600,1976,1996,20,60,60,2036,2036,30304.638965721868,0.046423464972455857,80.98935329090793,56.444603956584096,4571.411971205169,0,0.0,624314.4836558723,624314.4836558723
601,1972,1996,24,64,61,2036,2033,32136.0855568459,0.04670722985003379,75.05379210816572,56.444603956584096,0.0,0,0.0,564901.3053301111,564901.3053301111
602,1979,1997,18,62,66,2041,2045,38112.730853763846,0.04609633179699648,119.63847443000016,65.43476600099916,7828.515579043582,0,0.0,963258.6997473188,963258.6997473188
603,1971,1997,26,58,62,2029,2033,31001.028183163133,0.010220206487404073,30.620571438477366,45.894628338236,1405.319745673323,0,0.0,216970.23131274816,216970.23131274816
604,1973,1997,24,66,60,2039,2033,12329.480040148152,0.025377151551621544,17.943139047389106,61.67854274766627,0.0,0,0.0,132386.07484152736,132386.07484152736
605,1974,1997,23,60,66,2034,2040,13329.942963739446,0.045411760500461106,29.973598992874155,53.204452782151094,1594.7289323275045,0,0.0,227764.32682939473,227764.32682939473
606,1978,1997,19,60,69,2038,2047,36068.327568374356,0.03908743220450806,84.17667320770556,59.88208033754007,5040.674307570681,0,0.0,655046.8876123289,655046.8876123289
607,1979,1997,18,64,60,2043,2039,33835.466334722456,0.04035432386333491,84.71015788400629,69.41974325046002,0.0,0,0.0,665548.5770600825,665548.5770600825
608,1978,1997,19,59,68,2037,2046,22086.198478979113,0.019764524702397163,32.81750258461212,58.13794207528162,1907.9420643195845,0,0.0,246870.64110427082,246870.64110427082
609,1978,1997,19,64,61,2042,2039,34104.48229890654,0.051461402681592695,111.72600602747453,67.39780898102913,0.0,0,0.0,891025.8221224329,891025.8221224329
610,1973,1997,24,63,65,2036,2038,24293.109590313747,0.01630144989079999,32.74360864369167,56.444603956584096,1848.2000220025602,0,0.0,243588.68442088156,243588.68442088156
611,1971,1997,26,62,63,2033,2034,16438.842197764086,0.025806071403554617,24.11476505264433,51.654808526360284,1245.6435714525073,0,0.0,178006.50935340713,178006.50935340713
612,1971,1997,26,63,59,2034,2030,31593.743600640584,0.04834667341759418,61.72327008925711,53.204452782151094,0.0,0,0.0,455763.121847525,455763.121847525
613,1970,1997,27,67,62,2037,2032,28743.515883682074,0.008588790311325652,30.183890144972175,58.13794207528162,0.0,0,0.0,217210.06660212806,217210.06660212806
614,1978,1997,19,59,70,2037,2048,17039.60325327548,0.020159702973052303,25.52246808427535,58.13794207528162,1483.8237711018241,0,0.0,192100.16214701388,192100.16214701388
615,1974,1997,23,61,69,2035,2043,33260.38451209407,0.01857046902233572,45.47493316836939,54.80058636561562,2492.053002563825,0,0.0,337181.42055975785,337181.42055975785
616,1974,1998,24,59,60,2033,2034,34713.342703034956,0.04108607763585896,64.5459247767427,51.654808526360284,3334.107385499498,0,0.0,486051.39379668183,486051.39379668183
617,1972,1998,26,58,67,2030,2039,10004.040790134559,0.030556456961861492,13.520360697943582,47.271467188383085,639.1272871079443,0,0.0,98649.26698431934,98649.26698431934
618,1971,1998,27,59,64,2030,2035,31209.294623671485,0.008134481081093294,29.538985523969398,47.271467188383085,1396.3511849744423,0,0.0,211201.74295767298,211201.74295767298
619,1979,1998,19,65,67,2044,2046,20211.12238917288,0.05202242528680863,80.51384367548015,71.5023355479738,5756.92786674129,0,0.0,672576.9748786504,672576.9748786504
620,1970,1998,28,66,59,2036,2029,13897.897736071038,0.03324921788376268,18.80354643443776,56.444603956584096,0.0,0,0.0,136561.48125033034,136561.48125033034
621,1979,1998,19,61,62,2040,2041,37215.99464681867,0.05214919084080213,122.66555394375386,63.52889903009626,7792.807590963565,0,0.0,989907.6670641081,989907.6670641081
622,1978,1998,20,58,64,2036,2042,21319.541618895786,0.05320392082450541,58.86963273553298,56.444603956584096,3322.8731048267177,0,0.0,459811.22813128046,459811.22813128046
623,1976,1998,22,58,68,2034,2044,11268.752476680436,0.03323145254986316,18.812278784220684,53.204452782151094,1000.8969982997322,0,0.0,141550.23689863057,141550.23689863057
624,1970,1998,28,66,66,2036,2036,30275.432393930092,0.011955792444554376,36.17500074395157,56.444603956584096,2041.8835901214816,0,0.0,268879.3636537373,268879.3636537373
625,1976,1998,22,62,69,2038,2045,29991.562407346195,0.05330237525643386,91.97856993783564,59.88208033754007,5507.868114349521,0,0.0,730731.2573786897,730731.2573786897
626,1970,1998,28,58,62,2028,2032,31076.21504604421,0.019902610431972157,32.80406546290588,44.557891590520384,1461.6799926244942,0,0.0,234133.30768130222,234133.30768130222
627,1976,1998,22,61,61,2037,2037,29030.19219133613,0.05497331241078154,87.88390928458364,58.13794207528162,5109.389627336428,0,0.0,693601.0572687449,693601.0572687449
628,1980,1998,18,62,64,2042,2044,38703.99446452859,0.030020057285510063,80.77114108761364,67.39780898102913,5443.797938202738,0,0.0,641380.7944330396,641380.7944330396
629,1972,1998,26,60,60,2032,2032,29032.72435859751,0.04353903091319399,53.95844230740317,50.15029954015561,2706.032044436474,0,0.0,404194.8239205267,404194.8239205267
630,1973,1999,26,64,67,2037,2040,15580.690000169969,0.032603468232668895,27.48046041270373,58.13794207528162,1597.6574156758393,0,0.0,211937.0552044804,211937.0552044804
631,1978,1999,21,59,67,2037,2045,29720.604465103857,0.028614090208149087,48.36663617109479,58.13794207528162,2811.93669209133,0,0.0,371204.03217845404,371204.03217845404
632,1974,1999,25,63,59,2037,2033,33887.21786688563,0.042701151746419114,61.32952440445122,58.13794207528162,0.0,0,0.0,464100.38216013875,464100.38216013875
633,1980,1999,19,66,66,2046,2046,37924.2189194947,0.011286213449611312,54.829353098142334,75.85682778284541,4159.180795410604,0,0.0,434162.5808076471,434162.5808076471
634,1979,1999,20,63,70,2042,2049,11565.958871349148,0.03910969403133052,28.628485201640547,67.39780898102913,1929.4971770363888,0,0.0,231313.01848717904,231313.01848717904
635,1976,1999,23,63,59,2039,2035,36706.45007908523,0.019370479823278986,46.82422220782307,61.67854274766627,0.0,0,0.0,350719.6298616914,350719.6298616914
636,1979,1999,20,66,59,2045,2038,13345.366369638292,0.03079309513561641,23.541845750277194,73.64740561441303,0.0,0,0.0,182464.2058706516,182464.2058706516
637,1977,1999,22,67,63,2044,2040,37332.06108302151,0.04691326797728525,102.24764040405961,71.5023355479738,0.0,0,0.0,821688.7502811293,821688.7502811293
638,1981,1999,18,61,68,2042,2049,10942.654645338187,0.0418100212530381,28.924919417049455,67.39780898102913,1949.4761936619595,0,0.0,234629.5810590626,234629.5810590626
639,1976,1999,23,58,70,2034,2046,27853.950247170447,0.005496191056391782,27.194451886834752,53.204452782151094,1446.8659313495793,0,0.0,199342.6867035078,199342.6867035078
640,1971,1999,28,66,62,2037,2033,11249.704551480472,0.02488237897960181,14.770519873302728,58.13794207528162,0.0,0,0.0,109851.7600791548,109851.7600791548
641,1981,1999,18,61,65,2042,2046,33219.74134458287,0.043646074093805755,91.86302977245865,67.39780898102913,6191.366933022759,0,0.0,747128.890373385,747128.890373385
642,1974,1999,25,67,70,2041,2044,13766.506442879601,0.00584738324447905,15.943467747220756,65.43476600099916,1043.2570812838674,0,0.0,121500.4126604677,121500.4126604677
643,1971,1999,28,66,60,2037,2031,15452.17572128389,0.026775381273609535,19.407202700864733,58.13794207528162,0.0,0,0.0,142682.41193831936,142682.41193831936
644,1978,2000,22,66,59,2044,2037,32170.79673363876,0.016163169275259816,39.495157688772494,71.5023355479738,0.0,0,0.0,299822.4465491858,299822.4465491858
645,1974,2000,26,62,62,2036,2036,26451.461085869618,0.04896275574231923,58.980958461668365,56.444603956584096,3329.1568413486084,0,0.0,461157.57847520546,461157.57847520546
646,1980,2000,20,66,69,2046,2049,34892.89360862935,0.035307328246673986,86.9884631670411,75.85682778284541,6598.668869556629,0,0.0,723110.2461917996,723110.2461917996
647,1975,2000,25,65,64,2040,2039,14569.833569880364,0.04997276062730508,38.52188683814722,63.52889903009626,0.0,0,0.0,308997.11619400315,308997.11619400315
648,1974,2000,26,59,60,2033,2034,24522.31209130605,0.042372220329834696,41.59789696218818,51.654808526360284,2148.7314026810946,0,0.0,315750.92099119065,315750.92099119065
649,1976,2000,24,67,62,2043,2038,38733.69402964612,0.05213621595470561,102.20944797160759,69.41974325046002,0.0,0,0.0,815043.4575275045,815043.4575275045
650,1978,2000,22,65,62,2043,2040,26334.46998400789,0.0531384175126603,78.71153598518343,69.41974325046002,0.0,0,0.0,639040.0996693338,639040.0996693338
651,1977,2000,23,66,59,2043,2036,16761.438040202975,0.014791654206713502,19.489883704946298,69.41974325046002,0.0,0,0.0,146812.43738697466,146812.43738697466
652,1973,2000,27,66,68,2039,2041,35415.833171007456,0.020757351956627666,50.40449866450986,61.67854274766627,3108.8760255536586,0,0.0,389808.2709248538,389808.2709248538
653,1980,2000,20,62,66,2042,2046,29078.641214911855,0.024408285306349777,48.985046667246344,67.39780898102913,3301.4848182058668,0,0.0,388535.7810940371,388535.7810940371
654,1972,2000,28,58,59,2030,2031,38421.85748759341,0.021867007050851175,40.860258503023864,47.271467188383085,1931.5243691345436,0,0.0,298549.5942992211,298549.5942992211
655,1977,2000,23,66,67,2043,2044,30699.9921192683,0.03950482791189217,75.88526021597919,69.41974325046002,5267.935280687623,0,0.0,620243.5557084489,620243.5557084489
656,1981,2000,19,62,62,2043,2043,28927.653706874902,0.02738367127052092,53.75485761049819,69.41974325046002,3731.648413785821,0,0.0,431338.00848667655,431338.00848667655
657,1977,2000,23,58,60,2035,2037,19057.501002325054,0.04305441530119378,36.00543592771396,54.80058636561562,1973.1190011883286,0,0.0,277671.4895353418,277671.4895353418
658,1974,2001,27,62,63,2036,2037,28627.257706531243,0.05143301435074415,63.03344776247265,56.444603956584096,3557.8979949708005,0,0.0,495446.4184596006,495446.4184596006
659,1982,2001,19,67,61,2049,2043,14972.493394604677,0.027277081937094546,26.577500179459093,82.89080385266533,0.0,0,0.0,214050.36722589564,214050.36722589564
660,1973,2001,28,58,59,2031,2032,39435.77587492348,0.04465714369983697,59.18533347715319,48.68961120403458,2881.710875983721,0,0.0,444899.44735041686,444899.44735041686
661,1973,2001,28,63,67,2036,2040,15907.771133602851,0.05257149051809162,35.82923360639997,56.444603956584096,2022.3669009811795,0,0.0,281921.1694422472,281921.1694422472
662,1976,2001,25,67,67,2043,2043,16573.524384098153,0.027948173968864936,29.862279625351473,69.41974325046002,2073.0317844653428,0,0.0,240747.55222694913,240747.55222694913
663,1982,2001,19,60,65,2042,2047,12192.44686081045,0.0361171632308623,25.45954241592562,67.39780898102913,1715.9173764929637,0,0.0,206149.0302908888,206149.0302908888
664,1974,2001,27,63,62,2037,2036,34881.74880875538,0.04160613034214779,63.39385133824888,58.13794207528162,0.0,0,0.0,493558.57445654273,493558.57445654273
665,1982,2001,19,58,69,2040,2051,21856.17778929911,0.052644839799891374,60.71752491644747,63.52889903009626,3857.3175097743456,0,0.0,493895.4488759856,493895.4488759856
666,1982,2001,19,64,66,2046,2048,14850.143087108856,0.028845005323398502,30.125729218545615,75.85682778284541,2285.242253163849,0,0.0,248529.6593461183,248529.6593461183
667,1980,2001,21,58,69,2038,2049,29998.014371398578,0.013134987190428295,34.47949692355601,59.88208033754007,2064.7040047743467,0,0.0,263648.99045308545,263648.99045308545
668,1976,2001,25,59,64,2035,2040,35656.209550551095,0.035153215308525824,54.96045290534064,54.80058636561562,3011.8650461324696,0,0.0,422056.5220859577,422056.5220859577
669,1979,2001,22,67,62,2046,2041,20710.880319100368,0.0513097034215891,58.66579732133106,75.85682778284541,0.0,0,0.0,480492.2847581954,480492.2847581954
670,1974,2001,27,62,66,2036,2040,34242.3784706749,0.013894406202451172,37.63443313713105,56.444603956584096,2124.2606735559066,0,0.0,284597.0541022119,284597.0541022119
671,1977,2001,24,65,69,2042,2046,17614.632344700847,0.017290371965307652,24.511374952761823,67.39780898102913,1652.0129669286232,0,0.0,193181.8580378608,193181.8580378608
672,1982,2002,20,67,62,2049,2044,18666.54816727497,0.02489183127510785,31.09240230946466,82.89080385266533,0.0,0,0.0,252256.94449210365,252256.94449210365
673,1974,2002,28,59,61,2033,2035,24840.2556877385,0.03063601239063141,30.842798384335428,51.654808526360284,1593.1788449599808,0,0.0,233515.22101784564,233515.22101784564
674,1978,2002,24,58,61,2036,2039,21773.7455868844,0.042713248667351135,38.14267969746084,56.444603956584096,2152.948449366018,0,0.0,298271.60965999163,298271.60965999163
675,1982,2002,20,60,59,2042,2041,23330.960477245433,0.01877739696097417,31.24356763659011,67.39780898102913,0.0,0,0.0,246317.08879182895,246317.08879182895
676,1984,2002,18,59,62,2043,2046,21589.695192293977,0.03369206270522567,42.23007768425594,69.41974325046002,2931.6011502880283,0,0.0,344547.6364740249,344547.6364740249
677,1983,2002,19,61,59,2044,2042,17211.967386805205,0.014579647286741288,21.832263192902023,71.5023355479738,0.0,0,0.0,172198.16723898172,172198.16723898172
678,1981,2002,21,61,65,2042,2046,25178.737232047948,0.016042639148150448,32.87453946684316,67.39780898102913,2215.6719313255985,0,0.0,259832.8792544344,259832.8792544344
679,1976,2002,26,62,68,2038,2044,38689.60280162583,0.012408896411497273,42.21246407729651,59.88208033754007,2527.7701651221937,0,0.0,324113.5083209732,324113.5083209732
680,1977,2002,25,66,62,2043,2039,27448.668789675805,0.02683070948843831,40.2768510618992,69.41974325046002,0.0,0,0.0,316542.7739034278,316542.7739034278
681,1982,2002,20,62,61,2044,2043,19790.152927959614,0.04698298278543952,52.539052164752086,71.5023355479738,0.0,0,0.0,436343.5321606779,436343.5321606779
682,1978,2002,24,64,65,2042,2043,35375.48651379903,0.025047088123652337,55.46629428631931,67.39780898102913,3738.3067071948963,0,0.0,443961.6084572298,443961.6084572298
683,1981,2002,21,64,68,2045,2049,36666.62272010889,0.0322252884524614,74.5564038385812,73.64740561441303,5490.88571465197,0,0.0,616098.2960452852,616098.2960452852
684,1977,2002,25,66,61,2043,2038,27814.074424288465,0.006640481206430422,27.483738048652487,69.41974325046002,0.0,0,0.0,209608.03875396485,209608.03875396485
685,1976,2002,26,61,68,2037,2044,38223.535615093235,0.030346021898091734,55.614138725229594,58.13794207528162,3233.2915757740748,0,0.0,432754.1846770806,432754.1846770806
686,1983,2003,20,65,69,2048,2052,35074.77783731548,0.021609551655780233,58.62709558495088,80.4765085948207,4718.103961731674,0,0.0,488205.36650665227,488205.36650665227
687,1984,2003,19,65,66,2049,2050,29639.520605978636,0.01257975374000497,41.318312106491014,82.89080385266533,3424.908104342354,0,0.0,340615.72796933644,340615.72796933644
688,1977,2003,26,58,65,2035,2042,11362.098444060777,0.019501459682445297,12.146131569745387,54.80058636561562,665.6151320959625,0,0.0,92686.52299761568,92686.52299761568
689,1981,2003,22,62,67,2043,2048,10000.349042660984,0.02582829142411461,15.763920016990614,69.41974325046002,1094.3272802002757,0,0.0,127702.40182069298,127702.40182069298
690,1980,2003,23,63,63,2043,2043,31693.848216476625,0.015028012553649148,40.11711950310869,69.41974325046002,2784.920135853827,0,0.0,320101.91187270574,320101.91187270574
691,1979,2003,24,63,63,2042,2042,19118.275367650822,0.016520833105867497,24.23424970379423,67.39780898102913,1633.3353323348854,0,0.0,192573.15064523695,192573.15064523695
692,1983,2003,20,63,62,2046,2045,39005.36499397856,0.016214674164252253,53.3561340323457,75.85682778284541,0.0,0,0.0,431828.2348101678,431828.2348101678
693,1982,2003,21,66,63,2048,2045,32772.06817775127,0.0354815505828451,68.55650415154939,80.4765085948207,0.0,0,0.0,571211.6437840894,571211.6437840894
694,1981,2003,22,66,69,2047,2050,18143.157329026006,0.011267823789619283,23.485759154107424,78.13253261633078,1835.0018431275873,0,0.0,190848.4945798673,190848.4945798673
695,1975,2003,28,63,62,2038,2037,39545.75208287427,0.04271241298410404,68.52041448018103,59.88208033754007,0.0,0,0.0,541715.8141291968,541715.8141291968
696,1981,2003,22,63,63,2044,2044,14488.043485808575,0.02403448405804329,22.709255655302563,71.5023355479738,1623.7648179101654,0,0.0,184762.0349040907,184762.0349040907
697,1979,2003,24,67,68,2046,2047,10620.141066757134,0.018450982339915524,15.650642522700652,75.85682778284541,1187.2080945353807,0,0.0,127930.8666173578,127930.8666173578
698,1977,2003,26,58,69,2035,2046,28853.021422569967,0.029093373963730833,36.034620199890945,54.80058636561562,1974.718316416281,0,0.0,277346.4551911015,277346.4551911015
699,1985,2003,18,61,62,2046,2047,28964.784975593724,0.011497068613397061,36.81231718111936,75.85682778284541,2792.465604695653,0,0.0,297488.45861119236,297488.45861119236
700,1982,2004,22,63,59,2045,2041,25415.63392620303,0.030444527779552796,39.13669756206217,73.64740561441303,0.0,0,0.0,315718.0091659773,315718.0091659773
701,1983,2004,21,58,67,2041,2050,23464.40937239818,0.012951250187013066,26.01289037595628,65.43476600099916,1702.1473947603424,0,0.0,205498.88756446258,205498.88756446258
702,1980,2004,24,63,59,2043,2039,13660.91482965546,0.011256262857087349,13.894171116012663,69.41974325046002,0.0,0,0.0,108261.27363064261,108261.27363064261
703,1978,2004,26,58,60,2036,2038,34212.127116001095,0.014762030147824602,33.573757305824195,56.444603956584096,1895.0574344617185,0,0.0,257902.91914199386,257902.91914199386
704,1981,2004,23,63,62,2044,2043,39355.76405167422,0.04782686118739634,94.92247880184061,71.5023355479738,0.0,0,0.0,793488.7183884186,793488.7183884186
705,1986,2004,18,64,59,2050,2045,19359.520609792555,0.029125021011768035,33.49552631573883,85.37752796824529,0.0,0,0.0,277541.0212599097,277541.0212599097
706,1983,2004,21,61,60,2044,2043,10481.855949430184,0.04410856315456231,23.281121246825524,71.5023355479738,0.0,0,0.0,193762.08277757466,193762.08277757466
707,1984,2004,20,65,68,2049,2052,28477.357470301635,0.047163904546820117,88.97214236567078,82.89080385266533,7374.972401184232,0,0.0,781128.5846416553,781128.5846416553
708,1980,2004,24,61,66,2041,2046,31146.13030130145,0.045856407100779255,65.47451411292448,65.43476600099916,4284.309510008331,0,0.0,537384.4643954212,537384.4643954212
709,1978,2004,26,58,59,2036,2037,26222.037013993126,0.026479797178803235,31.0300844003128,56.444603956584096,1751.4808247150343,0,0.0,240897.45663202467,240897.45663202467
710,1982,2004,22,63,66,2045,2048,15377.668357233702,0.04500017408818407,38.12029058355526,73.64740561441303,2807.460502746384,0,0.0,322770.71235588193,322770.71235588193
711,1984,2004,20,60,70,2044,2054,16801.821469898896,0.0489670510088264,43.61873154344792,71.5023355479738,3118.8411789966026,0,0.0,368134.4660027204,368134.4660027204
712,1978,2004,26,61,62,2039,2040,28750.87558255617,0.020827483263393502,34.484379550954344,61.67854274766627,2126.946278260286,0,0.0,271514.5377780671,271514.5377780671
713,1981,2004,23,60,67,2041,2048,33900.44191574117,0.01752339493962495,40.84334538285303,65.43476600099916,2672.5747478249777,0,0.0,324462.1619130651,324462.1619130651
714,1980,2005,25,64,61,2044,2041,35520.40781814539,0.05409528490382696,83.32669969902753,71.5023355479738,0.0,0,0.0,691647.0754288314,691647.0754288314
715,1985,2005,20,59,62,2044,2047,30220.59757176378,0.007591789955986451,31.657611562560085,71.5023355479738,2263.593164593586,0,0.0,254015.70358724147,254015.70358724147
716,1987,2005,18,62,69,2049,2056,15742.830414986274,0.025582773022835122,27.420466891454264,82.89080385266533,2272.9045426480393,0,0.0,233365.60253819654,233365.60253819654
717,1982,2005,23,58,63,2040,2045,31980.97151770841,0.025226369278693487,41.03017477169323,63.52889903009626,2606.6018302581024,0,0.0,328148.17564287665,328148.17564287665
718,1982,2005,23,65,69,2047,2051,20675.642777776342,0.00919597679107147,23.96461256301401,78.13253261633078,1872.4158727174226,0,0.0,196060.0917729386,196060.0917729386
719,1979,2005,26,60,64,2039,2043,19973.68471446136,0.007829282807335781,18.462706282929016,61.67854274766627,1138.752818709244,0,0.0,144080.61240602477,144080.61240602477
720,1981,2005,24,61,59,2042,2040,29252.031918956745,0.03857395743336035,48.025548910968105,67.39780898102913,0.0,0,0.0,389448.7031457367,389448.7031457367
721,1981,2005,24,64,61,2045,2042,33558.06434548045,0.03505513478121641,55.98661729145111,73.64740561441303,0.0,0,0.0,459042.6357049503,459042.6357049503
722,1984,2005,21,65,60,2049,2044,38238.17344725555,0.05073655574782518,97.37974374195262,82.89080385266533,0.0,0,0.0,825756.3121682323,825756.3121682323
723,1980,2005,25,67,68,2047,2048,15380.940460366313,0.05353382727048721,48.60437752607892,78.13253261633078,3797.583112352816,0,0.0,424203.3938475386,424203.3938475386
724,1983,2005,22,66,63,2049,2046,15694.45908916468,0.03410916150462949,29.985698576777498,82.89080385266533,0.0,0,0.0,252956.91271638212,252956.91271638212
725,1987,2005,18,58,70,2045,2057,12221.26653737044,0.03527413346072023,23.064139046282943,73.64740561441303,1698.6140034888213,0,0.0,193419.42960183413,193419.42960183413
726,1986,2005,19,66,61,2052,2047,18056.01268202822,0.019373083244862508,25.830417053492006,90.57701942151144,0.0,0,0.0,214731.90487574134,214731.90487574134
727,1978,2005,27,63,64,2041,2042,14318.257407166926,0.034767983062930205,22.805587366159617,65.43476600099916,1492.2782728199973,0,0.0,185563.66240960814,185563.66240960814
728,1978,2006,28,63,62,2041,2040,18918.72370922001,0.009603349304123772,17.799772560049085,65.43476600099916,0.0,0,0.0,140695.14425495695,140695.14425495695
729,1986,2006,20,61,61,2047,2047,29455.144603560646,0.018370101392877067,39.677775306671,78.13253261633078,3100.125073291916,0,0.0,330824.80014255515,330824.80014255515
730,1987,2006,19,63,61,2050,2048,21197.794433882766,0.03318299855143811,40.701529072515015,85.37752796824529,0.0,0,0.0,349273.846600148,349273.846600148
731,1980,2006,26,58,64,2038,2044,19387.221826409448,0.01855481268820329,19.75678987491582,59.88208033754007,1183.0776785016074,0,0.0,155659.5615024998,155659.5615024998
732,1987,2006,19,61,59,2048,2046,13511.98124272506,0.02745423725054734,21.32678026642191,80.4765085948207,0.0,0,0.0,178929.4021396224,178929.4021396224
733,1984,2006,22,63,61,2047,2045,36489.81474489319,0.015131631706767158,43.57691424724312,78.13253261633078,0.0,0,0.0,357157.85803911457,357157.85803911457
734,1983,2006,23,61,60,2044,2043,21206.644031430456,0.007524447220620396,20.890891749817623,71.5023355479738,0.0,0,0.0,167562.74718856308,167562.74718856308
735,1988,2006,18,58,62,2046,2050,38088.014182396575,0.0320995037444883,66.36764549051016,75.85682778284541,5034.439054326566,0,0.0,560326.1039582553,560326.1039582553
736,1986,2006,20,58,68,2044,2054,21971.059529273043,0.046990080333221336,48.53749728486716,71.5023355479738,3470.544417521439,0,0.0,410970.38287077344,410970.38287077344
737,1979,2006,27,63,64,2042,2043,13056.793026188105,0.005415997111359601,12.09688805279422,67.39780898102913,815.3037502471183,0,0.0,96246.90468428316,96246.90468428316
738,1983,2006,23,59,61,2042,2044,36701.71076395758,0.00921506573056752,36.2695243499162,67.39780898102913,2444.486473968437,0,0.0,289859.0788472039,289859.0788472039
739,1980,2006,26,61,69,2041,2049,31703.43453550003,0.005452708079018549,28.650548708342768,65.43476600099916,1874.7419505306377,0,0.0,226720.1317843974,226720.1317843974
740,1981,2006,25,58,69,2039,2050,29130.647406878066,0.01710110399904386,30.01193314873623,61.67854274766627,1851.09230165443,0,0.0,237601.45396353517,237601.45396353517
741,1985,2006,21,65,65,2050,2050,15978.110094004023,0.0488735023327241,48.82598859816282,85.37752796824529,4168.642207116872,0,0.0,435534.4215918038,435534.4215918038
742,1986,2007,21,58,67,2044,2053,10474.395886988863,0.008857258426979094,10.44756561548745,71.5023355479738,747.0253422980571,0,0.0,84859.78666645015,84859.78666645015
743,1988,2007,19,65,69,2053,2057,23768.21549790461,0.04163667373930825,64.74647551040455,93.29433000415678,6040.479052873738,0,0.0,587218.5999990903,587218.5999990903
744,1980,2007,27,58,69,2038,2049,27844.096440333687,0.023610019591260963,29.28667806111049,59.88208033754007,1753.7472084750905,0,0.0,232833.0100789433,232833.0100789433
745,1983,2007,24,67,60,2050,2043,34152.709554869885,0.04614919025208838,66.62893661818539,85.37752796824529,0.0,0,0.0,560815.3918793597,560815.3918793597
746,1979,2007,28,65,61,2044,2040,28503.508235576235,0.04214407468339695,44.6037126117438,71.5023355479738,0.0,0,0.0,365438.5588176571,365438.5588176571
747,1982,2007,25,65,61,2047,2043,33122.27592716655,0.026374782517837963,44.01653596930152,78.13253261633078,0.0,0,0.0,362707.7691561474,362707.7691561474
748,1984,2007,23,66,65,2050,2049,18065.605431465807,0.023422445995828947,27.588986768932106,85.37752796824529,0.0,0,0.0,235889.6625354412,235889.6625354412
749,1984,2007,23,62,67,2046,2051,11050.23744420417,0.04436866725025528,23.887522215239972,75.85682778284541,1812.0316588403525,0,0.0,205505.9039134756,205505.9039134756
750,1988,2007,19,67,69,2055,2057,29138.627880542164,0.04668215670719792,99.05860789975546,98.97595470140993,9804.420288270925,0,0.0,921291.3928577714,921291.3928577714
751,1982,2007,25,61,60,2043,2042,29479.66973730645,0.051814031073446336,61.248442828075724,69.41974325046002,0.0,0,0.0,514260.8087862056,514260.8087862056
752,1988,2007,19,59,64,2047,2052,33552.93142287123,0.03494227000397195,61.50397164930326,78.13253261633078,4805.46107092307,0,0.0,526960.9865485112,526960.9865485112
753,1986,2007,21,63,65,2049,2051,11685.28232042317,0.02955478646915826,20.439178346855925,82.89080385266533,1694.219923258879,0,0.0,176380.29534569694,176380.29534569694
754,1986,2007,21,58,65,2044,2051,31388.800235764174,0.005574623664905766,29.56571440989258,71.5023355479738,2114.0176324517033,0,0.0,239172.71322317506,239172.71322317506
755,1981,2007,26,58,64,2039,2045,14784.767876240749,0.013023130713561322,13.66640930417881,61.67854274766627,842.9242104748968,0,0.0,108310.94721992855,108310.94721992855
756,1986,2008,22,58,68,2044,2054,38275.939225603506,0.0423388319766859,68.43354638775914,71.5023355479738,4893.158396555385,0,0.0,580054.426358165,580054.426358165
757,1988,2008,20,61,61,2049,2049,13312.95590233308,0.019459372314797493,17.94526968425899,82.89080385266533,1487.4978294810933,0,0.0,153180.39023225597,153180.39023225597
758,1987,2008,21,65,68,2052,2055,26066.614446390176,0.022844298758555513,41.25149765430682,90.57701942151144,3736.437704200582,0,0.0,361138.9995822446,361138.9995822446
759,1981,2008,27,61,66,2042,2047,33678.78544959056,0.020389791584037285,37.09150076869809,67.39780898102913,2499.885883628409,0,0.0,303019.8723508814,303019.8723508814
760,1984,2008,24,62,62,2046,2046,28966.49793261847,0.02367600884498438,38.74752695186888,75.85682778284541,2939.2644789990786,0,0.0,326140.02364507015,326140.02364507015
761,1981,2008,27,64,59,2045,2040,19558.268882908214,0.05017792217162652,33.20898911125725,73.64740561441303,0.0,0,0.0,274831.7596269513,274831.7596269513
762,1985,2008,23,60,61,2045,2046,20466.702251254705,0.031079969800567913,30.544395122887195,73.64740561441303,2249.5154568621724,0,0.0,257615.1547093295,257615.1547093295
763,1986,2008,22,67,65,2053,2051,35137.25124555411,0.04793821396747361,97.98436469402917,93.29433000415678,0.0,0,0.0,884684.7595438256,884684.7595438256
764,1988,2008,20,66,64,2054,2052,18878.286665759697,0.027959461686628093,33.63599028634904,96.09315990428149,0.0,0,0.0,296974.18009550456,296974.18009550456
765,1984,2008,24,61,65,2045,2049,22888.257763970898,0.04203130744471852,42.55483090003997,73.64740561441303,3134.0528921480004,0,0.0,363379.5131396499,363379.5131396499
766,1986,2008,22,59,63,2045,2049,31972.031471751372,0.030746667495662974,47.40421491442958,73.64740561441303,3491.197443635803,0,0.0,399658.5019843904,399658.5019843904
767,1985,2008,23,63,59,2048,2044,20356.898610099175,0.025710046278591518,26.42931670248847,80.4765085948207,0.0,0,0.0,220016.24066797798,220016.24066797798
768,1981,2008,27,60,68,2041,2049,20628.139816516472,0.010267274224066661,18.636056939859316,65.43476600099916,1219.446025040991,0,0.0,149802.79173559765,149802.79173559765
769,1987,2008,21,59,67,2046,2054,16356.829913203273,0.020550124736634014,20.593728081621634,75.85682778284541,1562.1748844943197,0,0.0,172656.32589665914,172656.32589665914
770,1985,2009,24,64,64,2049,2049,18028.023965851226,0.021783691651952982,24.47762002396294,82.89080385266533,2028.9696001863852,0,0.0,210559.97809840736,210559.97809840736
771,1984,2009,25,65,69,2049,2053,26706.353295162877,0.0257887551761661,39.391096601919415,82.89080385266533,3265.159661971094,0,0.0,340734.5923902621,340734.5923902621
772,1991,2009,18,60,61,2051,2052,30892.894211083218,0.04010730480909147,67.43292708624345,87.93885380729265,5929.974316834988,0,0.0,603920.9374338067,603920.9374338067
773,1991,2009,18,59,60,2050,2051,22358.74285102306,0.04852634831346921,57.030375548110534,85.37752796824529,4869.1124833983395,0,0.0,512347.5596014451,512347.5596014451
774,1990,2009,19,58,63,2048,2053,13516.117170407002,0.021860328778287606,17.818696969835525,80.4765085948207,1433.986519841474,0,0.0,152284.4958033517,152284.4958033517
775,1984,2009,25,67,59,2051,2043,16187.563415084578,0.0245929686594013,18.955794989431265,87.93885380729265,0.0,0,0.0,157231.06523420094,157231.06523420094
776,1991,2009,18,60,65,2051,2056,33189.6016391676,0.052572101436284054,98.01504075777311,87.93885380729265,8619.33034011364,0,0.0,892612.8659841235,892612.8659841235
777,1991,2009,18,58,59,2049,2050,35719.267070825226,0.03866232196772658,69.51911840345618,82.89080385266533,5762.495607591102,0,0.0,611773.5463803065,611773.5463803065
778,1989,2009,20,62,69,2051,2058,30658.948879236268,0.017663619176135754,40.48810010765055,87.93885380729265,3560.4771163017117,0,0.0,350706.2944462102,350706.2944462102
779,1983,2009,26,63,70,2046,2053,30918.26257161571,0.0426319147035918,57.56482848500632,75.85682778284541,4366.685280736158,0,0.0,497285.7830074091,497285.7830074091
780,1983,2009,26,63,67,2046,2050,24552.839799386205,0.021681419791843286,30.258603470273986,75.85682778284541,2295.321672393982,0,0.0,255167.597123242,255167.597123242
781,1983,2009,26,64,61,2047,2044,34617.9627302976,0.02522843282020087,42.513288432248146,78.13253261633078,0.0,0,0.0,355219.58416164195,355219.58416164195
782,1989,2009,20,62,67,2051,2056,34106.1297838781,0.050088701427311436,94.72114802668627,87.93885380729265,8329.66918877769,0,0.0,859849.6961760538,859849.6961760538
783,1990,2009,19,65,64,2055,2054,24377.802697436127,0.014086164661407826,32.16067514391154,98.97595470140993,0.0,0,0.0,282169.14942629985,282169.14942629985
784,1985,2010,25,61,70,2046,2055,26367.555480074436,0.05408536712605708,58.550562556114556,75.85682778284541,4441.459940407899,0,0.0,513313.8894970353,513313.8894970353
785,1991,2010,19,59,64,2050,2055,23004.166982669034,0.05485911769514752,64.17980474485304,85.37752796824529,5479.513074600212,0,0.0,582468.1963526533,582468.1963526533
786,1982,2010,28,67,61,2049,2043,16603.339777142595,0.022526026714308093,17.902482127553114,82.89080385266533,0.0,0,0.0,148846.37466908066,148846.37466908066
787,1985,2010,25,64,62,2049,2047,23927.155592176747,0.04113688761194023,42.733653820677894,82.89080385266533,0.0,0,0.0,372611.3857296662,372611.3857296662
788,1983,2010,27,59,59,2042,2042,21197.234691377016,0.03659943401980945,27.808365144851653,67.39780898102913,1874.2228821074202,0,0.0,232580.00299382955,232580.00299382955
789,1991,2010,19,65,67,2056,2058,27430.452801253283,0.026303548881304855,48.899625824657626,101.94523334245224,4985.083765053325,0,0.0,446384.83111566585,446384.83111566585
790,1983,2010,27,62,65,2045,2048,30324.202444704188,0.04292509404581953,51.226740902570775,73.64740561441303,3772.7165655560725,0,0.0,440672.62286384834,440672.62286384834
791,1990,2010,20,62,61,2052,2051,28614.213551559118,0.042112659359954355,62.10396702226829,90.57701942151144,0.0,0,0.0,559397.0373488291,559397.0373488291
792,1986,2010,24,66,70,2052,2056,21722.654569889113,0.012933943684484247,25.715700138283495,90.57701942151144,2329.2514708630683,0,0.0,223534.26711170436,223534.26711170436
793,1986,2010,24,60,63,2046,2049,29623.98211083621,0.0494563961970005,59.808717589390504,75.85682778284541,4536.899590091233,0,0.0,521949.8925268802,521949.8925268802
794,1988,2010,22,62,64,2050,2052,32748.018761681775,0.020345225659728502,42.70894165762506,85.37752796824529,3646.38386086804,0,0.0,370682.42724199215,370682.42724199215
795,1982,2010,28,63,66,2045,2048,27655.148054769666,0.014268638954125574,27.721158850199334,73.64740561441303,2041.5914299422059,0,0.0,231416.7264478093,231416.7264478093
796,1982,2010,28,59,70,2041,2052,31730.33218988619,0.0422876689538063,43.68241177868223,65.43476600099916,2858.348393097361,0,0.0,364388.14331363427,364388.14331363427
797,1992,2010,18,67,60,2059,2052,14009.51744231554,0.027192959421065057,22.494226335821992,111.39830899459781,0.0,0,0.0,199884.18116177336,199884.18116177336
798,1987,2011,24,59,59,2046,2046,18158.38118255346,0.0396179461230529,28.47776492076533,75.85682778284541,2160.2329092348523,0,0.0,246857.7659975914,246857.7659975914
799,1991,2011,20,63,61,2054,2052,29091.22844600123,0.021225590008767108,39.371790731129394,96.09315990428149,0.0,0,0.0,348194.3910857573,348194.3910857573
800,1989,2011,22,67,69,2056,2058,27859.097977824673,0.01823175134626787,39.47238246630408,101.94523334245224,4024.02124110989,0,0.0,356622.8516387525,356622.8516387525
801,1987,2011,24,62,62,2049,2049,23845.687827658207,0.05416528284092337,58.3421606899644,82.89080385266533,4836.028598092521,0,0.0,525876.35958984,525876.35958984
802,1986,2011,25,61,68,2047,2054,30968.46485462157,0.023417360689717566,37.29419816412392,78.13253261633078,2913.8901544583155,0,0.0,319994.645115149,319994.645115149
803,1986,2011,25,58,63,2044,2049,17787.293478251475,0.006683820193723202,14.703109425355308,71.5023355479738,1051.3066637303314,0,0.0,121702.50238131544,121702.50238131544
804,1989,2011,22,60,63,2049,2052,28901.196354399468,0.047906019712555176,61.65703885769138,82.89080385266533,5110.801514089061,0,0.0,551970.6376977643,551970.6376977643
805,1988,2011,23,66,66,2054,2054,16031.954561498354,0.03071005200046696,28.516571075430452,96.09315990428149,2740.247424273147,0,0.0,259424.15596808685,259424.15596808685
806,1987,2011,24,65,64,2052,2051,12829.822788731308,0.04240023681857017,26.55820473714522,90.57701942151144,0.0,0,0.0,240027.90732922743,240027.90732922743
807,1993,2011,18,63,64,2056,2057,12847.538104650092,0.05494463060166453,45.82505027147813,101.94523334245224,4671.6454428554425,0,0.0,439280.73189369374,439280.73189369374
808,1983,2011,28,67,61,2050,2044,39928.848922064695,0.017074824262843392,38.930429921040485,85.37752796824529,0.0,0,0.0,325528.5293282651,325528.5293282651
809,1993,2011,18,60,62,2053,2055,36751.32595608238,0.04745895027508521,93.62952869353121,93.29433000415678,8735.104148067967,0,0.0,865734.7695928949,865734.7695928949
810,1988,2011,23,62,61,2050,2049,10472.28738987031,0.005857489095759906,9.720444788839522,85.37752796824529,0.0,0,0.0,82632.8646273016,82632.8646273016
811,1986,2011,25,59,59,2045,2045,32869.0787350288,0.006946900834383281,28.052535954522895,73.64740561441303,2065.996493955653,0,0.0,233554.9135347777,233554.9135347777
812,1984,2012,28,67,61,2051,2045,38152.412315744325,0.025740755969447363,42.475607598255436,87.93885380729265,0.0,0,0.0,362071.0930221977,362071.0930221977
813,1985,2012,27,60,67,2045,2052,12079.849911632942,0.03691611198959133,16.307916916169695,73.64740561441303,1201.0357718512973,0,0.0,140461.44713914033,140461.44713914033
814,1992,2012,20,59,68,2051,2060,14153.06479988183,0.033942008401779626,23.13316416563553,87.93885380729265,2034.303941661924,0,0.0,207528.82258761747,207528.82258761747
815,1992,2012,20,64,66,2056,2058,21373.82975126941,0.02357429718297171,32.92239462310116,101.94523334245224,3356.281202044343,0,0.0,301481.75947396195,301481.75947396195
816,1990,2012,22,62,61,2052,2051,23291.780869912633,0.029707383531894137,34.847223477723446,90.57701942151144,0.0,0,0.0,310931.08110811363,310931.08110811363
817,1989,2012,23,58,68,2047,2057,31453.004838511002,0.03465791095197341,44.43194283091085,78.13253261633078,3471.5802224430863,0,0.0,387437.1860125016,387437.1860125016
818,1984,2012,28,59,69,2043,2053,30325.94841651054,0.023656130921119182,30.22097271158861,69.41974325046002,2097.93216641764,0,0.0,253778.89976913534,253778.89976913534
819,1988,2012,24,62,70,2050,2058,25010.78338646682,0.039544198827541135,44.16401528941455,85.37752796824529,3770.614450562003,0,0.0,395917.8208633724,395917.8208633724
820,1986,2012,26,66,64,2052,2050,18258.646403555806,0.012810328434331098,19.01571222763704,90.57701942151144,0.0,0,0.0,164914.17139031304,164914.17139031304
821,1988,2012,24,61,59,2049,2047,15380.680308677229,0.04025695727852817,24.15159097915824,82.89080385266533,0.0,0,0.0,211795.056777941,211795.056777941
822,1989,2012,23,59,59,2048,2048,35121.012393104524,0.013486421428846158,35.00116655649541,80.4765085948207,2816.771681212554,0,0.0,300188.21674369613,300188.21674369613
823,1991,2012,21,59,59,2050,2050,28290.922754578478,0.03998197848110609,50.41695675644427,85.37752796824529,4304.475135547134,0,0.0,452204.8543082418,452204.8543082418
824,1987,2012,25,63,62,2050,2049,38827.60440786474,0.031796753942605914,56.25155754134407,85.37752796824529,0.0,0,0.0,496065.5560579004,496065.5560579004
825,1987,2012,25,67,60,2054,2047,27178.216986460673,0.01885062621629894,28.848655028894,96.09315990428149,0.0,0,0.0,247387.70860455287,247387.70860455287
826,1992,2013,21,63,68,2055,2060,32216.9416977853,0.009745422063367312,34.592322948715086,98.97595470140993,3423.8081891885677,0,0.0,309162.5152911473,309162.5152911473
827,1985,2013,28,63,62,2048,2047,10952.312961189658,0.026166757207659878,12.617193596302977,80.4765085948207,0.0,0,0.0,109509.03037859705,109509.03037859705
828,1995,2013,18,61,62,2056,2057,17388.580564315947,0.039533988557400326,37.30998722311642,101.94523334245224,3803.5753534645155,0,0.0,351571.3896308622,351571.3896308622
829,1985,2013,28,64,69,2049,2054,36582.80305939625,0.014832679247647935,36.925322951478876,82.89080385266533,3060.7697019673565,0,0.0,320673.8358574236,320673.8358574236
830,1991,2013,22,64,66,2055,2057,36537.49878763563,0.01126102797584157,40.452038760894304,98.97595470140993,4003.7791559779535,0,0.0,362402.5455477016,362402.5455477016
831,1993,2013,20,61,63,2054,2056,36920.97597372795,0.036131526679932906,67.63317667560771,96.09315990428149,6499.085661123693,0,0.0,624471.9171368878,624471.9171368878
832,1989,2013,24,66,66,2055,2055,38223.19899068503,0.0437955766403653,87.19367480307709,98.97595470140993,8630.077207558827,0,0.0,819998.86749,819998.86749
833,1992,2013,21,64,63,2056,2055,39260.29400437212,0.04584869536359184,94.1036132403427,101.94523334245224,0.0,0,0.0,887450.5376281852,887450.5376281852
834,1986,2013,27,60,69,2046,2055,33682.28265740757,0.02581090294226747,37.13488309672249,75.85682778284541,2816.9344318041753,0,0.0,320048.8590756056,320048.8590756056
835,1986,2013,27,59,69,2045,2055,24073.21633142736,0.01842810837268213,22.678035252782742,73.64740561441303,1670.1784607996483,0,0.0,192873.69357329563,192873.69357329563
836,1986,2013,27,61,63,2047,2049,25896.437832655785,0.05426519161436427,50.089604997566575,78.13253261633078,3913.6276962114957,0,0.0,446450.6647309838,446450.6647309838
837,1987,2013,26,65,66,2052,2053,23192.214595237256,0.01891842408313283,27.61267440303569,90.57701942151144,2501.0737456836355,0,0.0,245576.75500455248,245576.75500455248
838,1988,2013,25,65,66,2053,2054,13890.36934672706,0.0178231530508383,16.660833377066524,93.29433000415678,1554.361287224314,0,0.0,148898.44994689542,148898.44994689542
839,1995,2013,18,61,62,2056,2057,16315.208189960289,0.04545118201458382,40.47960659044292,101.94523334245224,4126.702939473371,0,0.0,384696.0322645679,384696.0322645679
840,1995,2014,19,63,66,2058,2061,14647.759334303279,0.009136841780909495,16.07015834904758,108.15369805300759,1738.047053746911,0,0.0,146742.50134567902,146742.50134567902
841,1995,2014,19,64,69,2059,2064,26902.250934515625,0.04519024452417376,71.52483804366197,111.39830899459781,7967.7460091764215,0,0.0,698456.5645258722,698456.5645258722
842,1992,2014,22,63,68,2055,2060,25165.262811695917,0.01220393930065998,27.407309639086243,98.97595470140993,2712.664637325716,0,0.0,247128.39588013582,247128.39588013582
843,1994,2014,20,64,59,2058,2053,23252.394749131214,0.0542117249617217,58.06893399995277,108.15369805300759,0.0,0,0.0,545499.3611774988,545499.3611774988
844,1987,2014,27,66,65,2053,2052,11709.361809921049,0.0259303637459165,15.332018022585158,93.29433000415678,0.0,0,0.0,138194.29713693753,138194.29713693753
845,1988,2014,26,63,67,2051,2055,27228.62725270633,0.038360616859709054,43.993167851972785,87.93885380729265,3868.7087562543215,0,0.0,399516.9653362128,399516.9653362128
846,1989,2014,25,58,68,2047,2057,19416.264901674112,0.03190113526819515,23.49546845654787,78.13253261633078,1835.7604555171972,0,0.0,205895.16583881265,205895.16583881265
847,1990,2014,24,58,67,2048,2057,38212.576219022405,0.005791158599841041,30.983343966300758,80.4765085948207,2493.431347000289,0,0.0,266240.2980410857,266240.2980410857
848,1992,2014,22,59,67,2051,2059,24777.072122598925,0.029159043165683428,33.35288568886918,87.93885380729265,2933.01453864481,0,0.0,299716.1010229807,299716.1010229807
849,1994,2014,20,64,67,2058,2061,35793.84024434937,0.02534024004758618,56.18208077479139,108.15369805300759,6076.299800106471,0,0.0,527406.8441416883,527406.8441416883
850,1990,2014,24,64,62,2054,2052,22484.361029218202,0.0306925367288299,32.376624162299926,96.09315990428149,0.0,0,0.0,293543.68361511803,293543.68361511803
851,1989,2014,25,58,59,2047,2048,15264.74882144072,0.03338636589655273,18.95362217219416,78.13253261633078,1480.8945025665703,0,0.0,166322.22206031438,166322.22206031438
852,1988,2014,26,67,64,2055,2052,16894.801773928553,0.03263311338883741,25.3037639727188,98.97595470140993,0.0,0,0.0,229959.27902440386,229959.27902440386
853,1988,2014,26,63,64,2051,2052,35641.10350279593,0.013265114306898064,35.61823062646042,87.93885380729265,3132.226375934736,0,0.0,314030.4742404914,314030.4742404914
854,1995,2015,20,60,64,2055,2059,34771.328546820005,0.01928537838304452,42.02203161084096,98.97595470140993,4159.170697175811,0,0.0,384652.8669153431,384652.8669153431
855,1992,2015,23,65,65,2057,2057,27137.81409811292,0.01215005613328632,29.932068738091164,105.0035903427258,3142.974683884834,0,0.0,274473.65480281773,274473.65480281773
856,1995,2015,20,67,61,2062,2056,36819.55615140882,0.02187401628374491,48.351484213995185,121.72793999273989,0.0,0,0.0,447161.2385935905,447161.2385935905
857,1987,2015,28,62,62,2049,2049,30182.938432374,0.016025213171782356,28.6044487537385,82.89080385266533,2371.045750959755,0,0.0,251158.09992101896,251158.09992101896
858,1993,2015,22,67,62,2060,2055,17490.068582206906,0.01816236732590056,20.66459132317107,114.74025826443574,0.0,0,0.0,188856.0189387577,188856.0189387577
859,1988,2015,27,59,59,2047,2047,28819.86805272034,0.04251328819694211,39.62014208002197,78.13253261633078,3095.6220433309763,0,0.0,351759.9249577518,351759.9249577518
860,1992,2015,23,61,59,2053,2051,26630.124230210346,0.014975265746480424,26.36400218613094,93.29433000415678,0.0,0,0.0,234058.52269058808,234058.52269058808
861,1990,2015,25,67,66,2057,2056,37622.18951027906,0.007002955952534725,36.5970595637405,105.0035903427258,0.0,0,0.0,331005.5535706334,331005.5535706334
862,1990,2015,25,65,69,2055,2059,17144.39960997089,0.05042172759396876,40.81471305749637,98.97595470140993,4039.6751907298053,0,0.0,389200.81400511734,389200.81400511734
863,1991,2015,24,62,59,2053,2050,33175.488582382124,0.04012441707942344,50.284630057634864,93.29433000415678,0.0,0,0.0,455618.346860613,455618.346860613
864,1991,2015,24,59,64,2050,2055,22899.55642363179,0.03484553452733281,31.414486575170823,85.37752796824529,2682.091206179713,0,0.0,283121.5963611861,283121.5963611861
865,1991,2015,24,59,60,2050,2051,15121.250899374405,0.006523184315448007,12.603062368869296,85.37752796824529,1076.018309883678,0,0.0,110181.57736291132,110181.57736291132
866,1993,2015,22,64,59,2057,2052,25317.422723786796,0.03575645702705999,38.39546685825507,105.0035903427258,0.0,0,0.0,351484.6366023293,351484.6366023293
867,1989,2015,26,61,68,2050,2057,33206.58225594662,0.011170040760279821,29.900882825243073,85.37752796824529,2552.863459687416,0,0.0,262751.97951268515,262751.97951268515
868,1995,2016,21,58,67,2053,2062,23145.358397450334,0.04695901974901493,43.662081013529914,93.29433000415678,4073.424594744488,0,0.0,409114.05558103963,409114.05558103963
869,1998,2016,18,60,69,2058,2067,23471.163037903774,0.016873927837612875,28.2377138370913,108.15369805300759,3054.0131760440067,0,0.0,263735.6269625319,263735.6269625319
870,1998,2016,18,66,67,2064,2065,15674.173000689538,0.05111837423350515,54.87249682494629,129.14117153829775,7086.298525205088,0,0.0,567275.4373806078,567275.4373806078
871,1998,2016,18,65,68,2063,2066,21762.80730713718,0.042538482460552786,57.295618042517106,125.37977819252208,7183.711881574261,0,0.0,579019.4801926524,579019.4801926524
872,1988,2016,28,58,59,2046,2047,17107.999747199457,0.03886965649444364,19.857572163221647,75.85682778284541,1506.3324317709296,0,0.0,175134.51216987014,175134.51216987014
873,1994,2016,22,65,65,2059,2059,37820.65541758892,0.023294290477844024,53.79078584312728,111.39830899459781,5992.2025824149305,0,0.0,510870.8737753846,510870.8737753846
874,1993,2016,23,62,61,2055,2054,25742.069129842967,0.043762202591747464,47.56616649170461,98.97595470140993,0.0,0,0.0,447668.8697426471,447668.8697426471
875,1996,2016,20,60,69,2056,2065,18775.492764287563,0.021610278547366083,23.529561742360066,101.94523334245224,2398.7266622705342,0,0.0,218460.71637733918,218460.71637733918
876,1997,2016,19,65,61,2062,2058,29112.841024733276,0.034864621017673465,52.08040852860142,121.72793999273989,0.0,0,0.0,499805.9014923102,499805.9014923102
877,1993,2016,23,60,66,2053,2059,19526.49100772765,0.0474054617507815,37.180866233367794,93.29433000415678,3468.7640042162247,0,0.0,348551.0151714729,348551.0151714729
878,1992,2016,24,62,61,2054,2053,25189.909280628035,0.022520662500509873,29.213066308844933,96.09315990428149,0.0,0,0.0,266224.64926830016,266224.64926830016
879,1998,2016,18,61,68,2059,2066,23668.574693117545,0.03890569154771044,48.40359922557619,111.39830899459781,5392.079102981412,0,0.0,470889.1309821446,470889.1309821446
880,1998,2016,18,66,62,2064,2060,28680.686228493923,0.05450544230434329,91.05545414244955,129.14117153829775,0.0,0,0.0,913266.2358189621,913266.2358189621
881,1989,2016,27,60,66,2049,2055,19394.89605489331,0.04747671077439507,30.293460772963524,82.89080385266533,2511.049314950131,0,0.0,275159.5477554724,275159.5477554724
882,1990,2017,27,59,66,2049,2056,26230.086967829877,0.0542422871983547,43.40399737162187,82.89080385266533,3597.7922325527097,0,0.0,397660.89871132345,397660.89871132345
883,1992,2017,25,59,62,2051,2054,15954.732238160472,0.013244238828256923,14.12562552264698,87.93885380729265,1242.1913177726144,0,0.0,126408.67799978072,126408.67799978072
884,1992,2017,25,65,65,2057,2057,39042.291443522,0.02733572636292602,54.49985202992306,105.0035903427258,5722.680136289215,0,0.0,515637.0444219792,515637.0444219792
885,1998,2017,19,60,68,2058,2066,10150.796578294094,0.008004820518908507,9.849809611899127,108.15369805300759,1065.2933346449502,0,0.0,91196.86137155366,91196.86137155366
886,1991,2017,26,67,62,2058,2053,32616.04248129739,0.033894555634704414,44.79790455570788,108.15369805300759,0.0,0,0.0,415252.3157479067,415252.3157479067
887,1997,2017,20,65,63,2062,2060,13443.907817538402,0.05207664551422205,37.72791735132922,121.72793999273989,0.0,0,0.0,378005.7190446511,378005.7190446511
888,1999,2017,18,60,70,2059,2069,35948.878153456055,0.017472910214661616,43.32118386500055,111.39830899459781,4825.9066262051165,0,0.0,409446.0087022058,409446.0087022058
889,1998,2017,19,64,60,2062,2058,36866.885443955165,0.05045876320267929,90.2209380927271,121.72793999273989,0.0,0,0.0,886811.2259236051,886811.2259236051
890,1993,2017,24,64,59,2057,2052,23201.741395281962,0.04148559532487111,35.31397975229526,105.0035903427258,0.0,0,0.0,327495.005493579,327495.005493579
891,1997,2017,20,67,63,2064,2060,22898.72859339465,0.04654745855275342,55.8873396225677,129.14117153829775,0.0,0,0.0,555733.8065417977,555733.8065417977
892,1994,2017,23,62,59,2056,2053,13507.706065761744,0.039107658078081746,20.53177511924114,101.94523334245224,0.0,0,0.0,191386.30268984244,191386.30268984244
893,1990,2017,27,67,62,2057,2052,32016.49392407624,0.036611907543393045,44.419103975019134,105.0035903427258,0.0,0,0.0,409919.4860736232,409919.4860736232
894,1992,2017,25,66,68,2058,2060,26400.870462163904,0.050120651664305176,64.0878120581614,108.15369805300759,6931.333874216287,0,0.0,629673.7089070871,629673.7089070871
895,1993,2017,24,61,69,2054,2062,37946.64742928443,0.046049050864957045,69.47337836374102,96.09315990428149,6675.916456197616,0,0.0,657485.5011126833,657485.5011126833
896,1995,2018,23,65,65,2060,2060,30990.69727176125,0.025542854592024825,43.95610702784153,114.74025826443574,5043.535072673716,0,0.0,425260.5444910357,425260.5444910357
897,1991,2018,27,66,62,2057,2053,10324.33250905589,0.04632755370957321,17.069768842523338,105.0035903427258,0.0,0,0.0,160806.0270533441,160806.0270533441
898,1996,2018,22,67,63,2063,2059,23919.45094500662,0.010935454775455574,24.315134885076397,125.37977819252208,0.0,0,0.0,228616.03945886728,228616.03945886728
899,1995,2018,23,62,67,2057,2062,36870.93889598117,0.044175004042262836,70.36696602890056,105.0035903427258,7388.7840745591775,0,0.0,682628.4233887664,682628.4233887664
900,1993,2018,25,60,69,2053,2062,25968.75627854363,0.010163250443752422,22.249352885766346,93.29433000415678,2075.7384705036234,0,0.0,201813.9362830075,201813.9362830075
901,1991,2018,27,65,64,2056,2055,22706.43747975689,0.04467853272694008,39.96482064322835,101.94523334245224,0.0,0,0.0,381816.6999893759,381816.6999893759
902,1994,2018,24,67,63,2061,2057,17202.122214626994,0.012215460036080152,17.041067273436486,118.18246601236882,0.0,0,0.0,158632.83180830244,158632.83180830244
903,1997,2018,21,66,70,2063,2067,25707.594556643588,0.015912993634686474,32.01461619257746,125.37977819252208,4013.9854771440882,0,0.0,310971.85893213557,310971.85893213557
904,1996,2018,22,58,59,2054,2055,14136.558080680312,0.03943812704056827,21.392353574682662,96.09315990428149,2055.658852780909,0,0.0,201672.23421086554,201672.23421086554
905,1991,2018,27,62,59,2053,2050,12293.19583118343,0.04979420905963298,18.583119747885174,93.29433000415678,0.0,0,0.0,171516.80705517018,171516.80705517018
906,1993,2018,25,58,59,2051,2052,26719.317259429256,0.012801790566998846,22.5253029726335,87.93885380729265,1980.8493250753918,0,0.0,202499.84695317558,202499.84695317558
907,1995,2018,23,58,64,2053,2059,26970.645164230173,0.014133619211983407,24.712458405381234,93.29433000415678,2305.5322496856347,0,0.0,225135.7045930233,225135.7045930233
908,1993,2018,25,63,69,2056,2062,33445.169432265466,0.018787870222064063,36.492433616475026,101.94523334245224,3720.2296602654947,0,0.0,340556.38295959274,340556.38295959274
909,1993,2018,25,60,70,2053,2063,13559.31297224741,0.0516874711500735,24.914649552513644,93.29433000415678,2324.395537290125,0,0.0,235914.2389311843,235914.2389311843
910,2001,2019,18,64,67,2065,2068,28050.464920548882,0.05185544724598385,88.39697146684469,133.0154066844467,11758.159109335778,0,0.0,928912.1458433088,928912.1458433088
911,1992,2019,27,61,64,2053,2056,14836.564359253676,0.037820480175032846,19.715809086478448,93.29433000415678,1839.373199212873,0,0.0,184829.6971748857,184829.6971748857
912,2000,2019,19,61,59,2061,2059,37843.05506529359,0.047243116374481635,80.12879769417358,118.18246601236882,0.0,0,0.0,795202.6663096258,795202.6663096258
913,1995,2019,24,64,61,2059,2056,33207.16305192161,0.00720201896942322,28.21673623053373,111.39830899459781,0.0,0,0.0,260806.90966819072,260806.90966819072
914,1999,2019,20,58,61,2057,2060,20639.986149552486,0.03253316897204258,29.208035377671923,105.0035903427258,3066.948581512905,0,0.0,280331.164624952,280331.164624952
915,1992,2019,27,65,66,2057,2058,28354.930603096644,0.023672897256635263,33.626950320043235,105.0035903427258,3530.950515881012,0,0.0,319233.60860630276,319233.60860630276
916,1991,2019,28,59,59,2050,2050,23323.45739488997,0.04250142060710956,29.202163314468198,85.37752796824529,2493.208515114275,0,0.0,268847.7011044016,268847.7011044016
917,1996,2019,23,67,63,2063,2059,12103.244189237708,0.024762965771557892,15.663655871978762,125.37977819252208,0.0,0,0.0,150941.50786421917,150941.50786421917
918,1998,2019,21,65,69,2063,2067,10874.65558066267,0.05036244721782029,29.96310885207312,125.37977819252208,3756.767941831323,0,0.0,308773.4593313896,308773.4593313896
919,1998,2019,21,67,70,2065,2068,25548.28529342939,0.040505738316863965,59.23603716903545,133.0154066844467,7879.305574414251,0,0.0,611476.7906295202,611476.7906295202
920,1999,2019,20,63,66,2062,2065,25072.818614991294,0.04157431798515579,52.94504462112997,121.72793999273989,6444.891214553845,0,0.0,534331.9004131033,534331.9004131033
921,1993,2019,26,64,60,2057,2053,36585.45316388035,0.05171520570837451,63.09027596885644,105.0035903427258,0.0,0,0.0,599118.0416594318,599118.0416594318
922,1999,2019,20,64,68,2063,2067,19497.602797259533,0.019284979702238227,25.241472231006128,125.37977819252208,3164.770189576254,0,0.0,247744.50036635046,247744.50036635046
923,1992,2019,27,63,60,2055,2052,11291.572081470058,0.044048193182221765,16.036340882635592,98.97595470140993,0.0,0,0.0,150070.02779304396,150070.02779304396
924,1996,2020,24,59,69,2055,2065,36807.83759350395,0.03790274919306104,50.63673157151832,98.97595470140993,5011.818850250052,0,0.0,483522.35223485023,483522.35223485023
925,1997,2020,23,65,68,2062,2065,17114.333979331335,0.010380709237992943,17.240892986274332,121.72793999273989,2098.698386854452,0,0.0,166518.61727955987,166518.61727955987
926,1996,2020,24,63,68,2059,2064,35326.36975858429,0.029201028625470207,47.91937339368883,111.39830899459781,5338.137164137657,0,0.0,466372.1392473491,466372.1392473491
927,1994,2020,26,62,68,2056,2062,27191.26601857047,0.021260559813810566,28.52706178483767,101.94523334245224,2908.1979702298286,0,0.0,269436.83268090955,269436.83268090955
928,1992,2020,28,60,68,2052,2060,10191.37130219772,0.05391773935284283,16.224615847311423,90.57701942151144,1469.577344708489,0,0.0,153567.53791487406,153567.53791487406
929,1999,2020,21,61,59,2060,2058,31851.12563018938,0.02229030492052125,36.37013642527569,114.74025826443574,0.0,0,0.0,348467.17739327735,348467.17739327735
930,1997,2020,23,65,64,2062,2061,23217.20584036922,0.011620230674822731,23.405934462747833,121.72793999273989,0.0,0,0.0,225168.2204559623,225168.2204559623
931,1997,2020,23,64,69,2061,2066,23632.094634398585,0.04400946342414975,48.04900995765963,118.18246601236882,5678.55048624908,0,0.0,484038.9271356841,484038.9271356841
932,1994,2020,26,64,59,2058,2053,22929.51705762466,0.02022462663744754,21.33241167251531,108.15369805300759,0.0,0,0.0,197432.78772697452,197432.78772697452
933,1994,2020,26,64,68,2058,2062,28682.60209719523,0.016133803956154248,29.11795302390246,108.15369805300759,3149.214299268806,0,0.0,276805.73617963784,276805.73617963784
934,1999,2020,21,64,67,2063,2066,14806.768029295188,0.013546820121042413,16.310977096487594,125.37977819252208,2045.0666904609225,0,0.0,159294.1324712204,159294.1324712204
935,1994,2020,26,67,68,2061,2062,12523.829867781486,0.024655195377970056,16.51599667631027,118.18246601236882,1951.9012158584349,0,0.0,161985.2961196098,161985.2961196098
936,1996,2020,24,66,67,2062,2063,29851.560479318698,0.03512247209832939,51.42060662765047,121.72793999273989,6259.324517960919,0,0.0,515739.60791486467,515739.60791486467
937,2001,2020,19,67,61,2068,2062,17049.828326040748,0.0465075491498959,38.46368233174121,145.3495263000754,0.0,0,0.0,391950.5548030009,391950.5548030009
938,1998,2021,23,64,65,2062,2063,17935.474119665145,0.018994632612321347,20.770097317703616,121.72793999273989,2528.301159932794,0,0.0,204248.2385984052,204248.2385984052
939,2002,2021,19,66,68,2068,2070,37807.49038993324,0.01568490707851642,47.572104026793205,145.3495263000754,6914.582785392302,0,0.0,483370.8268238715,483370.8268238715
940,2003,2021,18,60,60,2063,2063,35738.652727451714,0.04155786722274586,70.8058702519187,125.37977819252208,8877.624306914066,0,0.0,724551.0609340279,724551.0609340279
941,1998,2021,23,66,70,2064,2068,19411.195361561957,0.01739366793642118,22.96079380219589,129.14117153829775,2965.1838110648637,0,0.0,228140.31909222566,228140.31909222566
942,1994,2021,27,61,65,2055,2059,10187.724130794108,0.008094285084023763,7.938651850364089,98.97595470140993,785.7356459319002,0,0.0,73823.65572820982,73823.65572820982
943,1993,2021,28,65,65,2058,2058,13958.959588718852,0.030659154187838943,17.922168705454325,108.15369805300759,1938.348822624769,0,0.0,174174.10578047967,174174.10578047967
944,1996,2021,25,58,59,2054,2055,16782.37213031688,0.045865265610661836,24.099237914190024,96.09315990428149,2315.7719224595853,0,0.0,230879.95868719858,230879.95868719858
945,1999,2021,22,67,62,2066,2061,23501.759182786758,0.02187271394821145,28.034893956352924,137.00586888498012,0.0,0,0.0,275025.7826128893,275025.7826128893
946,1999,2021,22,64,68,2063,2067,29883.88822629165,0.04853169407417453,70.05534570787647,125.37977819252208,8783.523706054006,0,0.0,723673.5400533394,723673.5400533394
947,1999,2021,22,60,62,2059,2061,30814.166709022353,0.032638118401679156,42.75319841834448,111.39830899459781,4762.634007914089,0,0.0,419464.4318342273,419464.4318342273
948,1994,2021,27,62,63,2056,2057,32804.82789370477,0.012694995234688686,28.384299229221355,101.94523334245224,2893.6440081849582,0,0.0,266793.42788988195,266793.42788988195
949,2000,2021,21,66,64,2066,2064,20396.762794496426,0.025385788533261264,28.78634060058203,137.00586888498012,0.0,0,0.0,289728.82086100185,289728.82086100185
950,2002,2021,19,62,64,2064,2066,11040.181126781992,0.024595528147195452,15.30612408238472,129.14117153829775,1976.6507957097153,0,0.0,153859.93560256597,153859.93560256597
951,1997,2021,24,59,69,2056,2066,29245.13443768755,0.017991406897014974,27.713790228136123,101.94523334245224,2825.28881161111,0,0.0,262001.82393430112,262001.82393430112
952,1999,2022,23,61,62,2060,2061,19357.35716610116,0.011105575796214396,17.51299159090032,114.74025826443574,2009.445178122794,0,0.0,169066.8144720365,169066.8144720365
953,2002,2022,20,60,64,2062,2066,17215.947555404462,0.03861919216458518,29.037041536182944,121.72793999273989,3534.619249683173,0,0.0,294563.97103012673,294563.97103012673
954,1996,2022,26,61,67,2057,2063,26367.463653761995,0.010279577298832,21.665872834783542,105.0035903427258,2274.9944355612024,0,0.0,205338.44812946202,205338.44812946202
955,2000,2022,22,61,65,2061,2065,32138.528421927764,0.023023725257077694,37.61631874890919,118.18246601236882,4445.589312053392,0,0.0,371185.52814108087,371185.52814108087
956,1995,2022,27,61,70,2056,2065,12436.88904420018,0.05462908977438817,21.95427802822904,101.94523334245224,2238.133996452882,0,0.0,215995.40865776574,215995.40865776574
957,1995,2022,27,64,62,2059,2057,39318.39797699342,0.04469090519540198,60.273146277690316,111.39830899459781,0.0,0,0.0,592257.7682701502,592257.7682701502
958,2002,2022,20,66,63,2068,2065,35983.046361335044,0.0194719760809744,44.0444195091085,145.3495263000754,0.0,0,0.0,443942.4334553263,443942.4334553263
959,2000,2022,22,59,69,2059,2069,22335.714276084735,0.0263743227045134,26.103599990411023,111.39830899459781,2907.896897603188,0,0.0,255191.80788661685,255191.80788661685
960,1997,2022,25,58,65,2055,2062,38032.99116260324,0.039454382687411485,48.1390071495826,98.97595470140993,4764.604191007937,0,0.0,463621.73730040994,463621.73730040994
961,2004,2022,18,64,63,2068,2067,33385.50104272191,0.005810019866973361,31.948996227693875,145.3495263000754,0.0,0,0.0,318319.2687214273,318319.2687214273
962,2003,2022,19,58,59,2061,2062,24766.96945547225,0.014750449021930793,24.64675696811199,118.18246601236882,2912.8145176990097,0,0.0,240523.57463558216,240523.57463558216
963,2000,2022,22,67,65,2067,2065,17590.7902276076,0.048278119158610175,42.44906151378502,141.11604495152952,0.0,0,0.0,446909.615877441,446909.615877441
964,2002,2022,20,67,69,2069,2071,39374.546653018464,0.03869194491350023,87.48155592018168,149.71001208907768,13096.864794381723,0,0.0,937879.3063460852,937879.3063460852
965,2002,2022,20,60,68,2062,2070,36687.29854991476,0.05219641417382289,84.31792297361604,121.72793999273989,10263.847068044797,0,0.0,869866.6405397973,869866.6405397973
966,2005,2023,18,59,70,2064,2075,10040.388128696912,0.023905038489372542,12.610287405600804,129.14117153829775,1628.5072889939293,0,0.0,127666.28021378996,127666.28021378996
967,1997,2023,26,67,70,2064,2067,38291.85692220915,0.02119097874512157,45.41513786264094,129.14117153829775,5864.964109154755,0,0.0,457961.5633620328,457961.5633620328
968,1998,2023,25,66,64,2064,2062,16561.416667196176,0.007997165043065415,14.354915801825477,129.14117153829775,0.0,0,0.0,140328.42893985336,140328.42893985336
969,2000,2023,23,66,62,2066,2062,31041.498566790702,0.010672040855195838,28.279600755519994,137.00586888498012,0.0,0,0.0,277466.22960020695,277466.22960020695
970,2004,2023,19,67,67,2071,2071,37865.78649536697,0.021598575236792275,55.15511951255647,158.82735182530251,8760.141571787413,0,0.0,583381.6105768001,583381.6105768001
971,1996,2023,27,66,68,2062,2064,12447.96160014515,0.0179295795567392,13.03019004566172,121.72793999273989,1586.1381919723067,0,0.0,129111.33628693045,129111.33628693045
972,2002,2023,21,64,70,2066,2072,33323.66401547157,0.03864235667442724,62.72472660077746,137.00586888498012,8593.655668512341,0,0.0,658520.6096434908,658520.6096434908
973,2002,2023,21,65,64,2067,2066,18877.960883098483,0.038191223742636254,35.14941395494699,141.11604495152952,0.0,0,0.0,368773.1968587462,368773.1968587462
974,2004,2023,19,62,70,2066,2074,14977.030731123588,0.006234207861229231,13.730525486810835,137.00586888498012,1881.162574567883,0,0.0,136892.16958357347,136892.16958357347
975,2001,2023,22,67,63,2068,2064,28027.360169772583,0.022047928571777918,33.84492410207778,145.3495263000754,0.0,0,0.0,341717.93037510366,341717.93037510366
976,1996,2023,27,63,66,2059,2062,35547.82957912657,0.054572678392139605,69.16689562252968,111.39830899459781,7705.075210755656,0,0.0,699392.8897086633,699392.8897086633
977,2000,2023,23,61,66,2061,2066,33765.73584405029,0.038818053393636205,52.0661033569787,118.18246601236882,6153.300490382618,0,0.0,525998.7936233131,525998.7936233131
978,2002,2023,21,61,60,2063,2062,27435.862711628695,0.017681777775701915,28.580668891821528,125.37977819252208,0.0,0,0.0,283100.89204503177,283100.89204503177
979,1995,2023,28,62,62,2057,2057,19774.70382311454,0.011388732639499523,15.90329179054776,105.0035903427258,1669.9027362755112,0,0.0,151679.7741335927,151679.7741335927
980,2000,2024,24,63,70,2063,2070,19705.912374564745,0.038252799450331554,30.961816258696782,125.37977819252208,3881.9856549530264,0,0.0,318437.02100933105,318437.02100933105
981,2000,2024,24,58,67,2058,2067,23820.094895004673,0.0299485558456883,26.004978466567557,108.15369805300759,2812.534588948112,0,0.0,255529.32919389533,255529.32919389533
982,2002,2024,22,61,65,2063,2067,31868.176003154716,0.043991044200503406,56.72530694596146,125.37977819252208,7112.206402787379,0,0.0,587494.5997140055,587494.5997140055
983,1996,2024,28,58,63,2054,2059,31364.11137641815,0.022829808799310285,26.025547529069236,96.09315990428149,2500.877100307328,0,0.0,247442.28317900604,247442.28317900604
984,2004,2024,20,63,65,2067,2069,34458.2899327168,0.04972021943242536,84.36650092219551,141.11604495152952,11905.466936539799,0,0.0,909666.3505766689,909666.3505766689
985,2003,2024,21,60,63,2063,2066,25433.839832196827,0.009252819274462056,22.319036136766886,125.37977819252208,2798.355800298717,0,0.0,220963.06454898394,220963.06454898394
986,1998,2024,26,63,60,2061,2058,28214.05842650731,0.024436317393827338,27.962659976945837,118.18246601236882,0.0,0,0.0,273258.5017854422,273258.5017854422
987,1998,2024,26,65,65,2063,2063,24401.421319302568,0.011900774351002587,22.502943984552985,125.37977819252208,2821.414125462002,0,0.0,223591.95645750765,223591.95645750765
988,1996,2024,28,64,64,2060,2060,23323.10670719856,0.031593588325250825,28.393637288560747,114.74025826443574,3257.893275556173,0,0.0,283428.06010970153,283428.06010970153
989,1997,2024,27,60,62,2057,2059,27481.433480340445,0.045623691052208586,38.0215236350839,105.0035903427258,3992.3964919846167,0,0.0,376334.7024393929,376334.7024393929
990,1997,2024,27,62,59,2059,2056,22081.111629836807,0.03862536313368246,25.72771266867118,111.39830899459781,0.0,0,0.0,251226.95671731705,251226.95671731705
991,2001,2024,23,65,61,2066,2062,20940.1202870301,0.041925293925525936,34.09445324295691,137.00586888498012,0.0,0,0.0,349490.7360446151,349490.7360446151
992,2002,2024,22,61,62,2063,2064,32604.163319787902,0.04864297107828323,64.34798308995596,125.37977819252208,8067.93584695484,0,0.0,670103.9933037261,670103.9933037261
993,2001,2024,23,60,64,2061,2065,12775.013138168913,0.04401739313700793,20.770211898523364,118.18246601236882,2454.674861766936,0,0.0,211745.1524375444,211745.1524375444
