person_id,birth_year,start_year,working_start_age,retirement_age,death_age,retirement_year,death_year,total_earning_points,current_pension_value,annual_pension,years_in_retirement,total_paid_pension
0,1930,1954,24,63,70,1993,2000,46.6843066866945,15.835134912616882,739.2522946857898,7,5174.766062800529
1,1929,1954,25,66,62,1995,1991,42.016002441550526,16.79949462879525,0.0,0,0.0
2,1930,1954,24,60,67,1990,1997,37.731616706406285,14.491391640013362,546.7836349034045,7,3827.4854443238314
3,1933,1954,21,65,70,1998,2003,95.73172224028926,18.357261367239552,1757.3722463009694,5,8786.861231504847
4,1936,1954,18,60,70,1996,2006,69.94108207493123,17.30347946765911,1210.2240776294332,10,12102.240776294331
5,1935,1954,19,61,65,1996,2000,70.73359516189961,17.30347946765911,1223.9373115576416,4,4895.749246230566
6,1934,1954,20,67,61,2001,1995,60.87616065133649,20.05947514203957,0.0,0,0.0
7,1932,1954,22,63,64,1995,1996,50.76767910257517,16.79949462879525,852.8713524001125,1,852.8713524001125
8,1927,1954,27,67,64,1994,1991,37.9251299760037,16.31018895999539,0.0,0,0.0
9,1935,1954,19,62,68,1997,2003,84.76359769275675,17.822583851688883,1510.7063274499794,6,9064.237964699876
10,1932,1954,22,61,69,1993,2001,44.80991966248223,15.835134912616882,709.57112327893,8,5676.56898623144
11,1928,1954,26,66,60,1994,1988,29.081972347514544,16.31018895999539,0.0,0,0.0
12,1936,1954,18,60,60,1996,1996,77.07384032662279,17.30347946765911,1333.645613585354,0,0.0
13,1935,1954,19,63,67,1998,2002,93.14712309582961,18.357261367239552,1709.92608427658,4,6839.70433710632
14,1930,1955,25,63,67,1993,1997,43.60719176384436,15.835134912616882,690.5257647408312,4,2762.1030589633247
15,1935,1955,20,66,66,2001,2001,101.25137082639426,20.05947514203957,2031.0493561894864,0,0.0
16,1927,1955,28,63,65,1990,1992,34.24498776703935,14.491391640013362,496.25752943963386,2,992.5150588792677
17,1933,1955,22,65,61,1998,1994,51.24653414629274,18.357261367239552,0.0,0,0.0
18,1934,1955,21,65,66,1999,2000,94.94920519520761,18.907979208256734,1795.2975976714877,1,1795.2975976714877
19,1928,1955,27,60,65,1988,1993,25.40557200097953,13.659526477531681,347.0280834242174,5,1735.140417121087
20,1927,1955,28,65,69,1992,1996,38.47574495177548,15.373917390890178,591.522924441556,4,2366.091697766224
21,1930,1955,25,60,68,1990,1998,32.852498675062506,14.491391640013362,476.07842465335085,8,3808.627397226807
22,1929,1955,26,61,64,1990,1993,36.46929473554399,14.491391640013362,528.4908328478455,3,1585.4724985435364
23,1929,1955,26,64,66,1993,1995,44.53284383462736,15.835134912616882,705.1835901638232,2,1410.3671803276463
24,1935,1955,20,65,65,2000,2000,102.70871158634127,19.47521858450444,2000.27460867682,0,0.0
25,1931,1955,24,66,67,1997,1998,71.21680148657573,17.822583851688883,1269.2674161435775,1,1269.2674161435775
26,1932,1955,23,66,67,1998,1999,87.36237687194883,18.357261367239552,1603.7339859016483,1,1603.7339859016483
27,1936,1955,19,67,65,2003,2001,118.34048957393776,21.281097178189782,0.0,0,0.0
28,1931,1956,25,64,62,1995,1993,41.47337291766981,16.79949462879525,0.0,0,0.0
29,1928,1956,28,63,61,1991,1989,30.25788154315758,14.926133389213764,0.0,0,0.0
30,1935,1956,21,65,68,2000,2003,100.79173155417412,19.47521858450444,1962.9410035282344,3,5888.823010584703
31,1929,1956,27,66,60,1995,1989,27.780592683137215,16.79949462879525,0.0,0,0.0
32,1933,1956,23,61,62,1994,1995,47.957556240884536,16.31018895999539,782.1968043484329,1,782.1968043484329
33,1937,1956,19,66,64,2003,2001,96.35942101335736,21.281097178189782,0.0,0,0.0
34,1932,1956,24,62,65,1994,1997,44.955405558108055,16.31018895999539,733.2311594259694,3,2199.693478277908
35,1935,1956,21,60,60,1995,1995,48.10668830806317,16.79949462879525,808.1680518404346,0,0.0
36,1930,1956,26,62,64,1992,1994,38.20246008109383,15.373917390890178,587.3214654155163,2,1174.6429308310326
37,1930,1956,26,65,70,1995,2000,49.678017133064834,16.79949462879525,834.5655819961212,5,4172.827909980606
38,1933,1956,23,67,64,2000,1997,65.51101167514294,19.47521858450444,0.0,0,0.0
39,1938,1956,18,62,61,2000,1999,82.46226597367748,19.47521858450444,0.0,0,0.0
40,1933,1956,23,62,65,1995,1998,48.43162011316298,16.79949462879525,813.6267419549336,3,2440.8802258648007
41,1935,1956,21,61,65,1996,2000,49.45138397790768,17.30347946765911,855.6810073090522,4,3422.724029236209
42,1934,1957,23,66,64,2000,1998,61.9460749294722,19.47521858450444,0.0,0,0.0
43,1932,1957,25,64,62,1996,1994,41.975093170766726,17.30347946765911,0.0,0,0.0
44,1930,1957,27,64,63,1994,1993,43.34668758314712,16.31018895999539,0.0,0,0.0
45,1934,1957,23,63,61,1997,1995,48.406054839336626,17.822583851688883,0.0,0,0.0
46,1931,1957,26,61,64,1992,1995,33.44012275112506,15.373917390890178,514.1056847170238,3,1542.3170541510713
47,1930,1957,27,65,64,1995,1994,42.90297626923728,16.79949462879525,0.0,0,0.0
48,1939,1957,18,64,69,2003,2008,121.42433562794095,21.281097178189782,2584.043086295343,5,12920.215431476716
49,1935,1957,22,62,66,1997,2001,49.02447440902377,17.822583851688883,873.7428059398019,4,3494.9712237592075
50,1936,1957,21,65,67,2001,2003,91.31813958121104,20.05947514203957,1831.7939509466028,2,3663.5879018932055
51,1934,1957,23,65,65,1999,1999,73.24313993556372,18.907979208256734,1384.8797670490771,0,0.0
52,1933,1957,24,67,65,2000,1998,53.34028557701708,19.47521858450444,0.0,0,0.0
53,1932,1957,25,67,69,1999,2001,73.83544117359172,18.907979208256734,1396.0789865427353,2,2792.1579730854705
54,1935,1957,22,62,60,1997,1995,44.35128109915479,17.822583851688883,0.0,0,0.0
55,1939,1957,18,62,67,2001,2006,100.14089812810892,20.05947514203957,2008.7738567023177,5,10043.869283511589
56,1939,1958,19,61,63,2000,2002,68.08683166150603,19.47521858450444,1326.0059293341874,2,2652.0118586683748
57,1931,1958,27,65,61,1996,1992,29.997236056966557,17.30347946765911,0.0,0,0.0
58,1933,1958,25,62,62,1995,1995,40.022205515890846,16.79949462879525,672.352826596748,0,0.0
59,1934,1958,24,63,62,1997,1996,46.57788546072507,17.822583851688883,0.0,0,0.0
60,1933,1958,25,66,70,1999,2003,66.74094283274289,18.907979208256734,1261.9363594209537,4,5047.745437683815
61,1932,1958,26,64,60,1996,1992,30.290403528304285,17.30347946765911,0.0,0,0.0
62,1934,1958,24,62,65,1996,1999,41.453469574995374,17.30347946765911,717.2892596541641,3,2151.867778962492
63,1939,1958,19,67,68,2006,2007,133.09971375571374,23.25442947623179,3095.1579068388833,1,3095.1579068388833
64,1935,1958,23,62,65,1997,2000,48.82349871099465,17.822583851688883,870.1608997095262,3,2610.4826991285786
65,1933,1958,25,63,69,1996,2002,49.22930109848668,17.30347946765911,851.8382007648723,6,5111.029204589234
66,1935,1958,23,60,60,1995,1995,38.94903946520823,16.79949462879525,654.3241792924999,0,0.0
67,1933,1958,25,63,70,1996,2003,51.30304352392827,17.30347946765911,887.7211602447144,7,6214.048121713001
68,1937,1958,21,64,69,2001,2006,85.73200080563373,20.05947514203957,1719.7389390379262,5,8598.694695189632
69,1933,1958,25,62,64,1995,1997,39.29430832298888,16.79949462879525,660.1245216142763,2,1320.2490432285526
70,1933,1959,26,63,65,1996,1998,39.265769690717384,17.30347946765911,679.4344396251596,2,1358.8688792503192
71,1938,1959,21,66,68,2004,2006,101.4313233762638,21.919530093535478,2223.326945173143,2,4446.653890346286
72,1936,1959,23,67,62,2003,1998,49.85696235908877,21.281097178189782,0.0,0,0.0
73,1936,1959,23,64,67,2000,2003,60.98073967254488,19.47521858450444,1187.6132345675733,3,3562.83970370272
74,1940,1959,19,64,63,2004,2003,83.90956386471436,21.919530093535478,0.0,0,0.0
75,1937,1959,22,62,61,1999,1998,51.908503436087706,18.907979208256734,0.0,0,0.0
76,1933,1959,26,64,63,1997,1996,43.61615896911807,17.822583851688883,0.0,0,0.0
77,1936,1959,23,62,62,1998,1998,48.0872372529851,18.357261367239552,882.7499826815059,0,0.0
78,1941,1959,18,65,60,2006,2001,81.58196109171861,23.25442947623179,0.0,0,0.0
79,1939,1959,20,62,64,2001,2003,70.73474625323448,20.05947514203957,1418.9018841452337,2,2837.8037682904674
80,1938,1959,21,60,62,1998,2000,50.57366021150542,18.357261367239552,928.3938988005685,2,1856.787797601137
81,1937,1959,22,61,70,1998,2007,51.638626693428066,18.357261367239552,947.9437668565721,9,8531.49390170915
82,1941,1959,18,62,63,2003,2004,101.35726709351468,21.281097178189782,2156.9938507328234,1,2156.9938507328234
83,1935,1959,24,60,70,1995,2005,39.26630418570018,16.79949462879525,659.6540662603106,10,6596.540662603106
84,1932,1960,28,66,70,1998,2002,45.443586761809534,18.357261367239552,834.219799651365,4,3336.87919860546
85,1933,1960,27,66,60,1999,1993,29.088474806600455,18.907979208256734,0.0,0,0.0
86,1936,1960,24,66,60,2002,1996,43.8306418263244,20.66125939630076,0.0,0,0.0
87,1936,1960,24,67,68,2003,2004,90.27140634313099,21.281097178189782,1921.0745708000281,1,1921.0745708000281
88,1938,1960,22,67,66,2005,2004,88.07788387569023,22.577115996341544,0.0,0,0.0
89,1937,1960,23,62,67,1999,2004,51.829497199513426,18.907979208256734,979.9910554228005,5,4899.9552771140025
90,1938,1960,22,62,69,2000,2007,53.477804496637326,19.47521858450444,1041.4919319914063,7,7290.443523939844
91,1935,1960,25,66,70,2001,2005,59.59237390191145,20.05947514203957,1195.3917429405203,4,4781.566971762081
92,1942,1960,18,65,60,2007,2002,75.56388239866368,23.952062360518745,0.0,0,0.0
93,1938,1960,22,67,63,2005,2001,65.0246582099673,22.577115996341544,0.0,0,0.0
94,1932,1960,28,60,63,1992,1995,24.951967404629627,15.373917390890178,383.60948561896026,3,1150.8284568568808
95,1940,1960,20,63,61,2003,2001,53.40478137552552,21.281097178189782,0.0,0,0.0
96,1938,1960,22,65,66,2003,2004,81.30769305621921,21.281097178189782,1730.3169172638275,1,1730.3169172638275
97,1933,1960,27,66,66,1999,1999,48.334067682675155,18.907979208256734,913.8995467944956,0,0.0
98,1942,1961,19,63,65,2005,2007,91.44432838336557,22.577115996341544,2064.549209118792,2,4129.098418237584
99,1940,1961,21,65,63,2005,2003,82.28102734018975,22.577115996341544,0.0,0,0.0
100,1933,1961,28,60,67,1993,2000,24.363172533095305,15.835134912616882,385.79412396092613,7,2700.5588677264827
101,1939,1961,22,64,65,2003,2004,86.01590360761134,21.281097178189782,1830.5128035433818,1,1830.5128035433818
102,1937,1961,24,65,69,2002,2006,59.76128522025647,20.66125939630076,1234.7434157920336,4,4938.973663168134
103,1942,1961,19,60,62,2002,2004,67.8915946971718,20.66125939630076,1402.7258488667837,2,2805.4516977335675
104,1937,1961,24,64,60,2001,1997,38.203844244633906,20.05947514203957,0.0,0,0.0
105,1937,1961,24,64,70,2001,2007,48.378776409837,20.05947514203957,970.4528627954157,6,5822.717176772494
106,1933,1961,28,65,61,1998,1994,30.0088973158463,18.357261367239552,0.0,0,0.0
107,1943,1961,18,62,70,2005,2013,91.25214762949916,22.577115996341544,2060.2103219464857,8,16481.682575571886
108,1940,1961,21,62,65,2002,2005,53.787429971963185,20.66125939630076,1111.3160429110935,3,3333.9481287332806
109,1936,1961,25,66,61,2002,1997,36.48714436126415,20.66125939630076,0.0,0,0.0
110,1940,1961,21,67,64,2007,2004,79.13063862612525,23.952062360518745,0.0,0,0.0
111,1940,1961,21,62,69,2002,2009,65.20278085801768,20.66125939630076,1347.171568667657,7,9430.200980673599
112,1941,1962,21,64,68,2005,2009,79.33106762611152,22.577115996341544,1791.066715908335,4,7164.26686363334
113,1941,1962,21,64,64,2005,2005,77.98626883982865,22.577115996341544,1760.7050377186877,0,0.0
114,1939,1962,23,64,60,2003,1999,42.321240103495015,21.281097178189782,0.0,0,0.0
115,1942,1962,20,60,69,2002,2011,49.41998578235865,20.66125939630076,1021.0791456108077,9,9189.712310497269
116,1939,1962,23,65,68,2004,2007,64.03736760366148,21.919530093535478,1403.6690062992518,3,4211.007018897755
117,1935,1962,27,62,67,1997,2002,33.24482243746371,17.822583851688883,592.508635526205,5,2962.543177631025
118,1935,1962,27,64,60,1999,1995,31.681812096181837,18.907979208256734,0.0,0,0.0
119,1938,1962,24,65,63,2003,2001,48.8784380189489,21.281097178189782,0.0,0,0.0
120,1942,1962,20,66,67,2008,2009,108.7166958177425,24.67062423133431,2682.1087501917996,1,2682.1087501917996
121,1935,1962,27,64,65,1999,2000,39.055481003657725,18.907979208256734,738.4602227856261,1,738.4602227856261
122,1937,1962,25,67,64,2004,2001,49.25295143543754,21.919530093535478,0.0,0,0.0
123,1941,1962,21,61,62,2002,2003,50.45003066606222,20.66125939630076,1042.3611701428395,1,1042.3611701428395
124,1941,1962,21,64,65,2005,2006,80.09545262054024,22.577115996341544,1808.3243245934152,1,1808.3243245934152
125,1941,1962,21,66,61,2007,2002,52.28812882787806,23.952062360518745,0.0,0,0.0
126,1939,1963,24,67,60,2006,1999,37.673100119032846,23.25442947623179,0.0,0,0.0
127,1936,1963,27,67,69,2003,2005,53.88819195614913,21.281097178189782,1146.7998497757546,2,2293.5996995515093
128,1943,1963,20,67,60,2010,2003,54.178316977834996,26.17306524702257,0.0,0,0.0
129,1941,1963,22,61,69,2002,2010,50.67665363256462,20.66125939630076,1047.0434860389048,8,8376.347888311238
130,1942,1963,21,66,63,2008,2005,66.88815566454936,24.67062423133431,0.0,0,0.0
131,1944,1963,19,63,69,2007,2013,93.81763349353575,23.952062360518745,2247.1258079534605,6,13482.754847720764
132,1943,1963,20,67,64,2010,2007,93.03095989992164,26.17306524702257,0.0,0,0.0
133,1935,1963,28,64,66,1999,2001,39.25544723033855,18.907979208256734,742.2411800420606,2,1484.4823600841212
134,1945,1963,18,60,70,2005,2015,66.3858139629861,22.577115996341544,1498.8002223538874,10,14988.002223538875
135,1943,1963,20,65,64,2008,2007,97.71685995575842,24.67062423133431,0.0,0,0.0
136,1939,1963,24,61,65,2000,2004,40.722525803210374,19.47521858450444,793.0800913306442,4,3172.320365322577
137,1936,1963,27,60,64,1996,2000,23.17925911060208,17.30347946765911,401.0818340958534,4,1604.3273363834137
138,1943,1963,20,60,60,2003,2003,51.80929085570971,21.281097178189782,1102.5585534334575,0,0.0
139,1936,1963,27,61,69,1997,2005,32.11054124812274,17.822583851688883,572.2928139177822,8,4578.342511342257
140,1942,1964,22,61,69,2003,2011,48.098515374147816,21.281097178189782,1023.5891798038949,8,8188.713438431159
141,1945,1964,19,61,66,2006,2011,74.28616574407565,23.25442947623179,1727.4824023552728,5,8637.412011776363
142,1942,1964,22,60,69,2002,2011,44.62407444233568,20.66125939630076,921.9895773729328,9,8297.906196356395
143,1944,1964,20,61,67,2005,2011,65.26254589778111,22.577115996341544,1473.4400689507681,6,8840.640413704608
144,1940,1964,24,64,64,2004,2004,50.8144985998768,21.919530093535478,1113.829931247916,0,0.0
145,1945,1964,19,64,70,2009,2015,105.83651837734098,25.410742958274337,2689.3845640852896,6,16136.307384511738
146,1944,1964,20,61,67,2005,2011,60.71994551988719,22.577115996341544,1370.8812532940321,6,8225.287519764193
147,1941,1964,23,62,64,2003,2005,51.85369109291797,21.281097178189782,1103.5034391962213,2,2207.0068783924426
148,1943,1964,21,63,61,2006,2004,50.37078189313719,23.25442947623179,0.0,0,0.0
149,1936,1964,28,65,69,2001,2005,46.7675534991274,20.05947514203957,938.1325768697518,4,3752.530307479007
150,1945,1964,19,61,62,2006,2007,74.11768431456541,23.25442947623179,1723.5644628346722,1,1723.5644628346722
151,1939,1964,25,67,64,2006,2003,46.39350851888954,23.25442947623179,0.0,0,0.0
152,1938,1964,26,60,68,1998,2006,31.878754215078885,18.357261367239552,585.2066231881927,8,4681.652985505541
153,1939,1964,25,63,60,2002,1999,37.70283398122991,20.66125939630076,0.0,0,0.0
154,1940,1965,25,66,69,2006,2009,65.57682919198255,23.25442947623179,1524.9517497198563,3,4574.855249159569
155,1942,1965,23,67,67,2009,2009,88.60690417693738,25.410742958274337,2251.5672663686005,0,0.0
156,1946,1965,19,63,70,2009,2016,98.39415743122439,25.410742958274337,2500.2686430808217,7,17501.880501565753
157,1940,1965,25,65,69,2005,2009,49.13697459086217,22.577115996341544,1109.3711750471823,4,4437.484700188729
158,1943,1965,22,65,67,2008,2010,82.45183003497256,24.67062423133431,2034.138115978652,2,4068.276231957304
159,1942,1965,23,64,65,2006,2007,58.18234248981196,23.25442947623179,1352.9971801912964,1,1352.9971801912964
160,1944,1965,21,64,66,2008,2010,82.55576273856074,24.67062423133431,2036.7022006542227,2,4073.4044013084454
161,1945,1965,20,63,67,2008,2012,86.43405347101333,24.67062423133431,2132.3820539744265,4,8529.528215897706
162,1941,1965,24,66,67,2007,2008,75.24526218340408,23.952062360518745,1802.2792121504774,1,1802.2792121504774
163,1941,1965,24,67,70,2008,2011,83.93341780998693,24.67062423133431,2070.6898112417703,3,6212.069433725311
164,1946,1965,19,61,61,2007,2007,74.70379800364321,23.952062360518745,1789.310028350858,0,0.0
165,1937,1965,28,65,65,2002,2002,45.2181820205376,20.66125939630076,934.2645881554705,0,0.0
166,1944,1965,21,62,68,2006,2012,69.29391285171026,23.25442947623179,1611.3904095422479,6,9668.342457253488
167,1941,1965,24,66,63,2007,2004,49.76455369593055,23.952062360518745,0.0,0,0.0
168,1944,1966,22,62,68,2006,2012,53.53476450594622,23.25442947623179,1244.9204057302031,6,7469.522434381219
169,1944,1966,22,60,62,2004,2006,42.46418234778982,21.919530093535478,930.7949228697571,2,1861.5898457395142
170,1940,1966,26,63,60,2003,2000,31.069869844011176,21.281097178189782,0.0,0,0.0
171,1948,1966,18,60,61,2008,2009,72.89815309705159,24.67062423133431,1798.442942215639,1,1798.442942215639
172,1946,1966,20,62,64,2008,2010,67.3886342031022,24.67062423133431,1662.519671887577,2,3325.039343775154
173,1945,1966,21,62,70,2007,2015,67.83298354958613,23.952062360518745,1624.7398520797292,8,12997.918816637834
174,1939,1966,27,67,64,2006,2003,40.666253495898566,23.25442947623179,0.0,0,0.0
175,1948,1966,18,62,70,2010,2018,95.12756707254479,26.17306524702257,2489.7800197802308,8,19918.240158241846
176,1943,1966,23,66,60,2009,2003,39.95853200743387,25.410742958274337,0.0,0,0.0
177,1941,1966,25,65,61,2006,2002,36.88610259667258,23.25442947623179,0.0,0,0.0
178,1939,1966,27,67,67,2006,2006,57.811959956587124,23.25442947623179,1344.3841456931914,0,0.0
179,1943,1966,23,65,60,2008,2003,41.20670782770796,24.67062423133431,0.0,0,0.0
180,1941,1966,25,66,63,2007,2004,46.51324048037134,23.952062360518745,0.0,0,0.0
181,1944,1966,22,60,68,2004,2012,44.63296924488143,21.919530093535478,978.3337125270219,8,7826.669700216175
182,1939,1967,28,63,60,2002,1999,22.95977170897022,20.66125939630076,0.0,0,0.0
183,1941,1967,26,67,65,2008,2006,49.54135783506507,24.67062423133431,0.0,0,0.0
184,1939,1967,28,64,67,2003,2006,41.002971630375505,21.281097178189782,872.5882238605799,3,2617.7646715817395
185,1940,1967,27,63,68,2003,2008,33.73146208844646,21.281097178189782,717.8425226666536,5,3589.212613333268
186,1949,1967,18,66,62,2015,2011,91.06285878401543,30.34175598583559,0.0,0,0.0
187,1945,1967,22,61,62,2006,2007,42.39546083201665,23.25442947623179,985.8822540304783,1,985.8822540304783
188,1942,1967,25,66,64,2008,2006,49.82258115705171,24.67062423133431,0.0,0,0.0
189,1945,1967,22,61,69,2006,2014,45.53183646538082,23.25442947623179,1058.816880007517,8,8470.535040060136
190,1943,1967,24,64,65,2007,2008,52.367358580754996,23.952062360518745,1254.3062383818901,1,1254.3062383818901
191,1944,1967,23,66,67,2010,2011,82.35846842120209,26.17306524702257,2155.5735676329705,1,2155.5735676329705
192,1942,1967,25,67,63,2009,2005,43.970785540845306,25.410742958274337,0.0,0,0.0
193,1940,1967,27,64,68,2004,2008,41.543513800874095,21.919530093535478,910.6143009494662,4,3642.4572037978646
194,1946,1967,21,63,70,2009,2016,81.28597316278163,25.410742958274337,2065.53697015263,7,14458.75879106841
195,1940,1967,27,62,68,2002,2008,35.426732446328586,20.66125939630076,731.9609086369395,6,4391.765451821637
196,1948,1968,20,61,65,2009,2013,59.19154430754157,25.410742958274337,1504.1011177022453,4,6016.404470808981
197,1950,1968,18,67,66,2017,2016,130.65586945536168,32.18956892537298,0.0,0,0.0
198,1946,1968,22,62,64,2008,2010,49.74891381805262,24.67062423133431,1227.3367587222112,2,2454.6735174444225
199,1950,1968,18,60,60,2010,2010,69.09355558634495,26.17306524702257,1808.3901385101872,0,0.0
200,1943,1968,25,67,68,2010,2011,69.62597462863702,26.17306524702257,1822.325176842855,1,1822.325176842855
201,1949,1968,19,63,65,2012,2014,86.05121071753251,27.767004920566244,2389.384391414408,2,4778.768782828816
202,1947,1968,21,62,62,2009,2009,59.96081758661106,25.410742958274337,1523.648923261349,0,0.0
203,1942,1968,26,67,67,2009,2009,62.037270642843545,25.410742958274337,1576.4131381381958,0,0.0
204,1943,1968,25,64,60,2007,2003,36.22961165549473,23.952062360518745,0.0,0,0.0
205,1942,1968,26,64,68,2006,2010,44.398981372841085,23.25442947623179,1032.4729811512618,4,4129.891924605047
206,1949,1968,19,65,62,2014,2011,87.01820001661349,29.45801552022873,0.0,0,0.0
207,1946,1968,22,64,60,2010,2006,50.06935439153023,26.17306524702257,0.0,0,0.0
208,1941,1968,27,64,61,2005,2002,26.982815854183823,22.577115996341544,0.0,0,0.0
209,1941,1968,27,65,60,2006,2001,31.41217652178362,23.25442947623179,0.0,0,0.0
210,1942,1969,27,63,70,2005,2012,36.322790607402915,22.577115996341544,820.0638568541607,7,5740.446997979125
211,1951,1969,18,64,64,2015,2015,104.06012308371531,30.34175598583559,3157.3668624621073,0,0.0
212,1951,1969,18,60,63,2011,2014,64.81328546027198,26.958257204433245,1747.2532197023656,3,5241.759659107097
213,1943,1969,26,65,66,2008,2009,49.72812823416145,24.67062423133431,1226.8239653926032,1,1226.8239653926032
214,1943,1969,26,61,70,2004,2013,31.92301346747189,21.919530093535478,699.7374543765884,9,6297.637089389295
215,1944,1969,25,67,60,2011,2004,32.1741536266896,26.958257204433245,0.0,0,0.0
216,1948,1969,21,60,68,2008,2016,51.961518085344025,24.67062423133431,1281.9230871732043,8,10255.384697385634
217,1941,1969,28,65,70,2006,2011,43.42998076813126,23.25442947623179,1009.9394249266112,5,5049.697124633056
218,1944,1969,25,66,60,2010,2004,38.71771367299988,26.17306524702257,0.0,0,0.0
219,1950,1969,19,64,65,2014,2015,111.91218555922961,29.45801552022873,3296.710899106504,1,3296.710899106504
220,1941,1969,28,61,67,2002,2008,28.100015542418355,20.66125939630076,580.5817101619887,6,3483.490260971932
221,1941,1969,28,60,64,2001,2005,24.241902743130666,20.05947514203957,486.27984547157047,4,1945.1193818862819
222,1949,1969,20,65,65,2014,2014,95.29800911831097,29.45801552022873,2807.2902316541035,0,0.0
223,1949,1969,20,61,63,2010,2012,64.91280315165845,26.17306524702257,1698.967032255489,2,3397.934064510978
224,1950,1970,20,67,63,2017,2013,88.01683684446094,32.18956892537298,0.0,0,0.0
225,1944,1970,26,67,62,2011,2006,38.891437963972514,26.958257204433245,0.0,0,0.0
226,1952,1970,18,62,70,2014,2022,87.53271776981606,29.45801552022873,2578.5401585910427,8,20628.32126872834
227,1942,1970,28,64,69,2006,2011,38.164057202770096,23.25442947623179,887.483376748693,5,4437.4168837434645
228,1952,1970,18,60,62,2012,2014,61.93223848884521,27.767004920566244,1719.672770861447,2,3439.345541722894
229,1950,1970,20,64,70,2014,2020,98.27913211260883,29.45801552022873,2895.108199087841,6,17370.649194527046
230,1952,1970,18,61,63,2013,2015,74.73646318385894,28.600015068183232,2137.4639732010874,2,4274.927946402175
231,1944,1970,26,63,66,2007,2010,47.21353643297906,23.952062360518745,1130.8615689033381,3,3392.5847067100144
232,1945,1970,25,61,62,2006,2007,36.400774794859565,23.25442947623179,846.4792503472574,1,846.4792503472574
233,1942,1970,28,66,63,2008,2005,34.25822665560824,24.67062423133431,0.0,0,0.0
234,1951,1970,19,64,65,2015,2016,104.25083567918671,30.34175598583559,3163.153417497326,1,3163.153417497326
235,1946,1970,24,60,66,2006,2012,39.926111720071624,23.25442947623179,928.4589492545571,6,5570.753695527343
236,1949,1970,21,60,68,2009,2017,52.3628985229413,25.410742958274337,1330.5801549166642,8,10644.641239333314
237,1950,1970,20,66,69,2016,2019,116.61532025054441,31.25200866541066,3644.4629989896534,3,10933.38899696896
238,1947,1971,24,66,66,2013,2013,72.96901907926976,28.600015068183232,2086.915045177665,0,0.0
239,1947,1971,24,67,61,2014,2008,40.755717592621075,29.45801552022873,0.0,0,0.0
240,1943,1971,28,61,70,2004,2013,31.17024796436715,21.919530093535478,683.2371882779087,9,6149.134694501178
241,1951,1971,20,66,68,2017,2019,119.12625541577349,32.18956892537298,3834.622809527627,2,7669.245619055254
242,1947,1971,24,64,63,2011,2010,47.55738378816665,26.958257204433245,0.0,0,0.0
243,1945,1971,26,62,63,2007,2008,40.620527102662905,23.952062360518745,972.9453982801238,1,972.9453982801238
244,1946,1971,25,60,66,2006,2012,34.79531730968048,23.25442947623179,809.1452524810719,6,4854.871514886431
245,1946,1971,25,65,68,2011,2014,47.481834529901484,26.958257204433245,1280.0275077954238,3,3840.0825233862715
246,1947,1971,24,60,65,2007,2012,39.073604276885355,23.952062360518745,935.89340629019,5,4679.46703145095
247,1943,1971,28,64,68,2007,2011,39.54060679283431,23.952062360518745,947.0790796747185,4,3788.316318698874
248,1945,1971,26,67,64,2012,2009,45.11065157895329,27.767004920566244,0.0,0,0.0
249,1947,1971,24,61,69,2008,2016,43.94157139934373,24.67062423133431,1084.065996127556,8,8672.527969020448
250,1953,1971,18,60,65,2013,2018,76.71047595488824,28.600015068183232,2193.920768197311,5,10969.603840986556
251,1943,1971,28,61,67,2004,2010,29.21516408130927,21.919530093535478,640.3826682678352,6,3842.2960096070115
252,1949,1972,23,61,67,2010,2016,45.141232625795126,26.17306524702257,1181.48442684596,6,7088.906561075759
253,1948,1972,24,62,64,2010,2012,46.24857452817007,26.17306524702257,1210.4669587075812,2,2420.9339174151623
254,1949,1972,23,63,70,2012,2019,49.00750645447349,27.767004920566244,1360.7916728660475,7,9525.541710062333
255,1949,1972,23,64,68,2013,2017,61.92885993999283,28.600015068183232,1771.166327439204,4,7084.665309756816
256,1949,1972,23,66,66,2015,2015,99.94843262095536,30.34175598583559,3032.6109537517573,0,0.0
257,1948,1972,24,63,64,2011,2012,45.329398560739435,26.958257204433245,1222.0015853226798,1,1222.0015853226798
258,1948,1972,24,64,64,2012,2012,53.31763491831717,27.767004920566244,1480.4710311298675,0,0.0
259,1947,1972,25,62,63,2009,2010,40.55008957644926,25.410742958274337,1030.4079031621516,1,1030.4079031621516
260,1949,1972,23,66,63,2015,2012,57.11782631771089,30.34175598583559,0.0,0,0.0
261,1947,1972,25,67,63,2014,2010,44.936753344368434,29.45801552022873,0.0,0,0.0
262,1951,1972,21,66,62,2017,2013,55.30813752080133,32.18956892537298,0.0,0,0.0
263,1947,1972,25,66,68,2013,2015,58.25895749908696,28.600015068183232,1666.2070623305335,2,3332.414124661067
264,1948,1972,24,61,70,2009,2018,46.20825061383888,25.410742958274337,1174.1859788997822,9,10567.67381009804
265,1946,1972,26,64,69,2010,2015,51.545983663572706,26.17306524702257,1349.116393648648,5,6745.58196824324
266,1952,1973,21,60,62,2012,2014,52.525259834196845,27.767004920566244,1458.4691482701642,2,2916.9382965403283
267,1950,1973,23,66,64,2016,2014,59.20616098041093,31.25200866541066,0.0,0,0.0
268,1953,1973,20,62,62,2015,2015,68.49369068888366,30.34175598583559,2078.218849451407,0,0.0
269,1947,1973,26,64,63,2011,2010,40.32197983201474,26.958257204433245,0.0,0,0.0
270,1949,1973,24,60,69,2009,2018,38.541309010614675,25.410742958274337,979.3632965441521,9,8814.26966889737
271,1948,1973,25,62,65,2010,2013,42.82072399792849,26.17306524702257,1120.7496031225276,3,3362.248809367583
272,1949,1973,24,63,70,2012,2019,46.08855250680055,27.767004920566244,1279.7410642381067,7,8958.187449666746
273,1947,1973,26,61,60,2008,2007,31.199048346414465,24.67062423133431,0.0,0,0.0
274,1948,1973,25,63,65,2011,2013,43.66992086434753,26.958257204433245,1177.2649587583264,2,2354.529917516653
275,1945,1973,28,60,69,2005,2014,22.412709273819722,22.577115996341544,506.0143370673077,9,4554.129033605769
276,1955,1973,18,64,67,2019,2022,107.52356300378881,34.1499136729282,3671.9203943850443,3,11015.761183155133
277,1947,1973,26,67,68,2014,2015,68.85048142966617,29.45801552022873,2028.1985505303262,1,2028.1985505303262
278,1950,1973,23,67,69,2017,2019,105.02138802156975,32.18956892537298,3380.59320835866,2,6761.18641671732
279,1948,1973,25,66,66,2014,2014,60.102958659086724,29.45801552022873,1770.5138889910424,0,0.0
280,1956,1974,18,64,63,2020,2019,107.7917464917864,35.17441108311604,0.0,0,0.0
281,1956,1974,18,67,67,2023,2023,136.4603372288627,38.43602869962015,5244.993438088411,0,0.0
282,1948,1974,26,64,64,2012,2012,42.94179312585662,27.767004920566244,1192.3649810235984,0,0.0
283,1955,1974,19,66,63,2021,2018,101.1607144477869,36.22964341560952,0.0,0,0.0
284,1952,1974,22,63,64,2015,2016,62.737564432405065,30.34175598583559,1903.5678711536725,1,1903.5678711536725
285,1953,1974,21,64,63,2017,2016,77.1688962205767,32.18956892537298,0.0,0,0.0
286,1956,1974,18,67,67,2023,2023,147.17214710415266,38.43602869962015,5656.712869879931,0,0.0
287,1947,1974,27,61,70,2008,2017,30.136227957545074,24.67062423133431,743.479555690426,9,6691.316001213834
288,1955,1974,19,67,70,2022,2025,133.76026916841303,37.31653271807781,4991.469460801979,3,14974.408382405938
289,1951,1974,23,63,66,2014,2017,51.11909595790503,29.45801552022873,1505.8671221080283,3,4517.601366324085
290,1950,1974,24,67,70,2017,2020,75.42430054144047,32.18956892537298,2427.8757209267446,3,7283.627162780234
291,1954,1974,20,60,64,2014,2018,54.39253475574828,29.45801552022873,1602.2961330194134,4,6409.184532077654
292,1954,1974,20,64,67,2018,2021,86.93722419422129,33.15525599313417,2882.425923491904,3,8647.277770475712
293,1948,1974,26,61,70,2009,2018,33.82698797978636,25.410742958274337,859.5688966069869,9,7736.1200694628815
294,1951,1975,24,65,69,2016,2020,64.63658992758872,31.25200866541066,2020.0232685195979,4,8080.0930740783915
295,1957,1975,18,67,65,2024,2022,121.67985923655448,39.589109560608755,0.0,0,0.0
296,1947,1975,28,65,61,2012,2008,28.821100133491953,27.767004920566244,0.0,0,0.0
297,1955,1975,20,66,68,2021,2023,109.33787311115358,36.22964341560952,3961.272154638255,2,7922.54430927651
298,1957,1975,18,63,63,2020,2020,108.97365138312578,35.17441108311604,3833.0840109782434,0,0.0
299,1948,1975,27,60,63,2008,2011,25.58518406591585,24.67062423133431,631.202461979732,3,1893.6073859391959
300,1954,1975,21,63,63,2017,2017,69.46507800996929,32.18956892537298,2236.0509165083176,0,0.0
301,1953,1975,22,60,70,2013,2023,43.11695005982084,28.600015068183232,1233.14542140498,10,12331.4542140498
302,1949,1975,26,64,62,2013,2011,39.82427686772028,28.600015068183232,0.0,0,0.0
303,1947,1975,28,64,67,2011,2014,38.6615667228697,26.958257204433245,1042.2484596414788,3,3126.7453789244364
304,1952,1975,23,60,64,2012,2016,43.17099860804945,27.767004920566244,1198.7293307754676,4,4794.91732310187
305,1954,1975,21,65,70,2019,2024,91.83903163752952,34.1499136729282,3136.2950022269547,5,15681.475011134773
306,1951,1975,24,61,69,2012,2020,38.53119483631994,27.767004920566244,1069.8958766153924,8,8559.167012923139
307,1957,1975,18,63,62,2020,2019,104.1788118768037,35.17441108311604,0.0,0,0.0
308,1948,1976,28,62,66,2010,2014,31.253490717964695,26.17306524702257,817.9996517585042,4,3271.998607034017
309,1955,1976,21,62,62,2017,2017,69.6881213519857,32.18956892537298,2243.2305855395,0,0.0
310,1958,1976,18,66,61,2024,2019,87.94857649697668,39.589109560608755,0.0,0,0.0
311,1954,1976,22,61,66,2015,2020,45.912559405945224,30.34175598583559,1393.0676741803707,5,6965.3383709018535
312,1955,1976,21,65,61,2020,2016,52.31188880921603,35.17441108311604,0.0,0,0.0
313,1949,1976,27,65,62,2014,2011,35.984322446606114,29.45801552022873,0.0,0,0.0
314,1951,1976,25,67,64,2018,2015,49.62359414019276,33.15525599313417,0.0,0,0.0
315,1948,1976,28,65,62,2013,2010,33.065985923146336,28.600015068183232,0.0,0,0.0
316,1952,1976,24,61,62,2013,2014,37.12133636106891,28.600015068183232,1061.670779277669,1,1061.670779277669
317,1955,1976,21,60,65,2015,2020,49.14529135197254,30.34175598583559,1491.1544380543469,5,7455.772190271735
318,1952,1976,24,64,60,2016,2012,35.99664829932374,31.25200866541066,0.0,0,0.0
319,1955,1976,21,61,60,2016,2015,47.15461599225229,31.25200866541066,0.0,0,0.0
320,1953,1976,23,62,64,2015,2017,47.97345562004479,30.34175598583559,1455.598884220712,2,2911.197768441424
321,1950,1976,26,61,68,2011,2018,36.96527904229205,26.958257204433245,996.519500055755,7,6975.636500390285
322,1955,1977,22,66,61,2021,2016,45.2120321271918,36.22964341560952,0.0,0,0.0
323,1958,1977,19,67,66,2025,2024,119.14572891097414,40.77678284742702,0.0,0,0.0
324,1953,1977,24,64,61,2017,2014,41.16429858541618,32.18956892537298,0.0,0,0.0
325,1959,1977,18,63,62,2022,2021,91.82676240698382,37.31653271807781,0.0,0,0.0
326,1950,1977,27,64,66,2014,2016,44.62819112228485,29.45801552022873,1314.6579467200013,2,2629.3158934400026
327,1953,1977,24,62,62,2015,2015,41.18671515831097,30.34175598583559,1249.6772611915871,0,0.0
328,1957,1977,20,62,61,2019,2018,63.81259647103062,34.1499136729282,0.0,0,0.0
329,1951,1977,26,67,63,2018,2014,41.03474217150708,33.15525599313417,0.0,0,0.0
330,1950,1977,27,61,70,2011,2020,32.01546698242523,26.958257204433245,863.0811934322596,9,7767.730740890336
331,1951,1977,26,67,68,2018,2019,64.51620092840803,33.15525599313417,2139.0511574858483,1,2139.0511574858483
332,1950,1977,27,62,60,2012,2010,30.411590874673383,27.767004920566244,0.0,0,0.0
333,1955,1977,22,67,70,2022,2025,107.48618479527272,37.31653271807781,4011.011731654152,3,12033.035194962456
334,1953,1977,24,62,68,2015,2021,47.55040936484383,30.34175598583559,1442.762917974683,6,8656.577507848098
335,1956,1977,21,61,60,2017,2016,47.467268769286676,32.18956892537298,0.0,0,0.0
336,1959,1978,19,62,67,2021,2026,83.63563113350052,36.22964341560952,3030.089092806174,4,12120.356371224696
337,1951,1978,27,62,67,2013,2018,34.491392001748224,28.600015068183232,986.4543309726138,5,4932.271654863069
338,1950,1978,28,66,67,2016,2017,42.81303838443274,31.25200866541066,1337.993446582851,1,1337.993446582851
339,1956,1978,22,65,68,2021,2024,94.88992798459776,36.22964341560952,3437.828254614844,3,10313.484763844532
340,1959,1978,19,63,69,2022,2028,91.72822954101652,37.31653271807781,3422.9794788386944,3,10268.938436516084
341,1951,1978,27,67,68,2018,2019,59.581042178660475,33.15525599313417,1975.4247057712125,1,1975.4247057712125
342,1950,1978,28,66,60,2016,2010,27.326129264412437,31.25200866541066,0.0,0,0.0
343,1950,1978,28,66,68,2016,2018,46.448266557724295,31.25200866541066,1451.6016289553038,2,2903.2032579106076
344,1960,1978,18,67,62,2027,2022,82.41405477222378,43.26008892283532,0.0,0,0.0
345,1960,1978,18,66,68,2026,2028,125.21536553346942,42.00008633284983,5259.056162605065,0,0.0
346,1951,1978,27,62,68,2013,2019,38.07447935363222,28.600015068183232,1088.930683227113,6,6533.584099362677
347,1953,1978,25,67,63,2020,2016,48.472198006287286,35.17441108311604,0.0,0,0.0
348,1958,1978,20,66,70,2024,2028,103.78945525044962,39.589109560608755,4108.93211514595,1,4108.93211514595
349,1958,1978,20,64,70,2022,2028,94.39136646170836,37.31653271807781,3522.3585148724123,3,10567.075544617237
350,1957,1979,22,63,64,2020,2021,67.32447028458293,35.17441108311604,2368.0985937429505,1,2368.0985937429505
351,1958,1979,21,64,65,2022,2023,72.06178123105613,37.31653271807781,2689.0958170316717,1,2689.0958170316717
352,1952,1979,27,63,67,2015,2019,38.76276201735592,30.34175598583559,1176.1302664676293,4,4704.521065870517
353,1957,1979,22,65,70,2022,2027,80.05763392248757,37.31653271807781,2987.473315600403,3,8962.419946801208
354,1952,1979,27,63,69,2015,2021,40.34923192991003,30.34175598583559,1224.2665494332164,6,7345.599296599298
355,1956,1979,23,61,65,2017,2021,48.05030242476113,32.18956892537298,1546.7185217868648,4,6186.874087147459
356,1961,1979,18,62,63,2023,2024,84.46483616009093,38.43602869962015,3246.492866757969,1,3246.492866757969
357,1956,1979,23,60,63,2016,2019,43.36934469383253,31.25200866541066,1355.3791361848362,3,4066.1374085545085
358,1957,1979,22,64,69,2021,2026,69.20520463158972,36.22964341560952,2507.279886306784,4,10029.119545227137
359,1961,1979,18,63,65,2024,2026,97.84664148721708,39.589109560608755,3873.661409975043,1,3873.661409975043
360,1957,1979,22,65,67,2022,2024,84.62841979431194,37.31653271807781,3158.039196133665,2,6316.07839226733
361,1960,1979,19,67,65,2027,2025,108.59468809621934,43.26008892283532,0.0,0,0.0
362,1961,1979,18,66,63,2027,2024,99.45248857311238,43.26008892283532,0.0,0,0.0
363,1957,1979,22,64,67,2021,2024,65.33725495428816,36.22964341560952,2367.1454487486267,3,7101.4363462458805
364,1952,1980,28,61,70,2013,2022,28.891872441735757,28.600015068183232,826.3079871816706,9,7436.771884635035
365,1956,1980,24,66,66,2022,2022,70.81696609393582,37.31653271807781,2642.643632239363,0,0.0
366,1953,1980,27,66,63,2019,2016,41.27311116718249,34.1499136729282,0.0,0,0.0
367,1961,1980,19,61,70,2022,2031,75.78985554852429,37.31653271807781,2828.2146242748977,3,8484.643872824694
368,1952,1980,28,60,63,2012,2015,25.47479120800038,27.767004920566244,707.3586528229442,3,2122.0759584688326
369,1961,1980,19,65,68,2026,2029,117.87565182474403,42.00008633284983,4950.787553180197,0,0.0
370,1954,1980,26,66,68,2020,2022,53.38308062230861,35.17441108311604,1877.7184226922093,2,3755.4368453844186
371,1959,1980,21,63,61,2022,2020,56.889623810350415,37.31653271807781,0.0,0,0.0
372,1953,1980,27,66,61,2019,2014,31.220766020337386,34.1499136729282,0.0,0,0.0
373,1957,1980,23,62,62,2019,2019,48.68659056452852,34.1499136729282,1662.6428648078497,0,0.0
374,1959,1980,21,63,66,2022,2025,68.93723690691502,37.31653271807781,2572.4986565307754,3,7717.495969592326
375,1958,1980,22,61,67,2019,2025,51.46515302073277,34.1499136729282,1757.530532822064,6,10545.183196932385
376,1953,1980,27,64,62,2017,2015,32.691002775089395,32.18956892537298,0.0,0,0.0
377,1961,1980,19,60,63,2021,2024,60.26424298902102,36.22964341560952,2183.352034203878,3,6550.056102611634
378,1963,1981,18,65,62,2028,2025,85.99302927681181,44.557891590520384,0.0,0,0.0
379,1953,1981,28,60,67,2013,2020,24.148357935561986,28.600015068183232,690.6434008289549,7,4834.503805802684
380,1955,1981,26,66,70,2021,2025,49.220753187900314,36.22964341560952,1783.250336645354,4,7133.001346581416
381,1960,1981,21,64,66,2024,2026,82.8323986985043,39.589109560608755,3279.260907243113,1,3279.260907243113
382,1953,1981,28,65,69,2018,2022,39.38006734323915,33.15525599313417,1305.6562137919568,4,5222.624855167827
383,1959,1981,22,63,63,2022,2022,57.99074410751801,37.31653271807781,2164.013499833874,0,0.0
384,1955,1981,26,62,61,2017,2016,34.05634079621537,32.18956892537298,0.0,0,0.0
385,1955,1981,26,66,64,2021,2019,48.26726991749937,36.22964341560952,0.0,0,0.0
386,1958,1981,23,61,66,2019,2024,48.56586161311982,34.1499136729282,1658.5199815394194,5,8292.599907697097
387,1961,1981,20,63,61,2024,2022,66.90539335923201,39.589109560608755,0.0,0,0.0
388,1960,1981,21,60,63,2020,2023,53.320535521977,35.17441108311604,1875.5184356219104,3,5626.555306865731
389,1960,1981,21,66,70,2026,2030,101.71873206563252,42.00008633284983,4272.195528424587,0,0.0
390,1957,1981,24,61,67,2018,2024,43.65590786413911,33.15525599313417,1447.4228008482114,6,8684.536805089268
391,1954,1981,27,61,68,2015,2022,33.48946239645736,30.34175598583559,1016.1290961301261,7,7112.903672910883
392,1957,1982,25,64,70,2021,2027,52.962521239832306,36.22964341560952,1918.81325891077,4,7675.25303564308
393,1955,1982,27,62,68,2017,2023,33.658151961448866,32.18956892537298,1083.441402463736,6,6500.648414782416
394,1964,1982,18,63,67,2027,2031,102.63339115122714,43.26008892283532,4439.929627654226,0,0.0
395,1959,1982,23,65,63,2024,2022,55.04731750042021,39.589109560608755,0.0,0,0.0
396,1955,1982,27,61,69,2016,2024,29.764857636883264,31.25200866541066,930.2115887925904,8,7441.692710340723
397,1959,1982,23,62,70,2021,2029,47.989597357961905,36.22964341560952,1738.6459999376368,4,6954.583999750547
398,1957,1982,25,65,60,2022,2017,33.96565074968251,37.31653271807781,0.0,0,0.0
399,1960,1982,22,66,62,2026,2022,56.127901181342374,42.00008633284983,0.0,0,0.0
400,1957,1982,25,62,62,2019,2019,39.53273451518845,34.1499136729282,1350.0394709484747,0,0.0
401,1961,1982,21,63,65,2024,2026,75.04753203625364,39.589109560608755,2971.064968036541,1,2971.064968036541
402,1963,1982,19,67,66,2030,2029,127.04319599069169,47.271467188383085,0.0,0,0.0
403,1956,1982,26,63,61,2019,2017,36.8051437199804,34.1499136729282,0.0,0,0.0
404,1959,1982,23,66,68,2025,2027,93.14560411659184,40.77678284742702,3798.17807225467,0,0.0
405,1962,1982,20,67,61,2029,2023,66.34862462704822,45.894628338236,0.0,0,0.0
406,1965,1983,18,60,69,2025,2034,72.7885627041002,40.77678284742702,2968.0834151614195,0,0.0
407,1962,1983,21,63,70,2025,2032,67.67956517239415,40.77678284742702,2759.754932243001,0,0.0
408,1964,1983,19,64,61,2028,2025,80.28502438835655,44.557891590520384,0.0,0,0.0
409,1956,1983,27,61,68,2017,2024,31.82035156087898,32.18956892537298,1024.2833997985135,7,7169.983798589595
410,1962,1983,21,67,66,2029,2028,93.6484349265352,45.894628338236,0.0,0,0.0
411,1955,1983,28,60,70,2015,2025,25.701149750115157,30.34175598583559,779.8180142734134,10,7798.180142734134
412,1964,1983,19,63,60,2027,2024,61.2323258795592,43.26008892283532,0.0,0,0.0
413,1960,1983,23,67,65,2027,2025,71.2055623214816,43.26008892283532,0.0,0,0.0
414,1955,1983,28,67,68,2022,2023,49.891443327854496,37.31653271807781,1861.7756772960072,1,1861.7756772960072
415,1959,1983,24,65,70,2024,2029,61.90936776878868,39.589109560608755,2450.9367434265955,1,2450.9367434265955
416,1955,1983,28,67,67,2022,2022,45.73658926480899,37.31653271807781,1706.730929713531,0,0.0
417,1961,1983,22,66,65,2027,2026,79.89453128582498,43.26008892283532,0.0,0,0.0
418,1960,1983,23,61,64,2021,2024,50.27004426417282,36.22964341560952,1821.265778177888,3,5463.797334533664
419,1960,1983,23,60,61,2020,2021,41.407683192524914,35.17441108311604,1456.4908706133062,1,1456.4908706133062
420,1956,1984,28,62,63,2018,2019,34.348815699097656,33.15525599313417,1138.8437775645687,1,1138.8437775645687
421,1961,1984,23,64,67,2025,2028,62.35315742160069,40.77678284742702,2542.561160032044,0,0.0
422,1962,1984,22,64,63,2026,2025,72.61705486518512,42.00008633284983,0.0,0,0.0
423,1963,1984,21,62,69,2025,2032,66.2871437415049,40.77678284742702,2702.9764659235266,0,0.0
424,1962,1984,22,65,63,2027,2025,65.52198221184568,43.26008892283532,0.0,0,0.0
425,1961,1984,23,64,70,2025,2031,63.37429308952528,40.77678284742702,2584.1997874207673,0,0.0
426,1965,1984,19,67,61,2032,2026,69.6882466436144,50.15029954015561,0.0,0,0.0
427,1961,1984,23,67,60,2028,2021,39.232653266362476,44.557891590520384,0.0,0,0.0
428,1964,1984,20,67,65,2031,2029,104.80980284012664,48.68961120403458,0.0,0,0.0
429,1966,1984,18,67,64,2033,2030,107.89682563363121,51.654808526360284,0.0,0,0.0
430,1965,1984,19,66,66,2031,2031,122.91468627697574,48.68961120403458,5984.668286091834,0,0.0
431,1962,1984,22,60,69,2022,2031,45.32505841085335,37.31653271807781,1691.374025137397,3,5074.122075412191
432,1956,1984,28,60,61,2016,2017,19.789110934256826,31.25200866541066,618.4494663981671,1,618.4494663981671
433,1964,1984,20,66,68,2030,2032,125.31066671923176,47.271467188383085,5923.619070172573,0,0.0
434,1964,1985,21,63,67,2027,2031,88.83165833913503,43.26008892283532,3842.8654389139074,0,0.0
435,1965,1985,20,67,61,2032,2026,68.7311883848475,50.15029954015561,0.0,0,0.0
436,1961,1985,24,65,70,2026,2031,62.23930580691885,42.00008633284983,2614.0562171872334,0,0.0
437,1962,1985,23,65,64,2027,2026,65.72082010073424,43.26008892283532,0.0,0,0.0
438,1958,1985,27,65,64,2023,2022,38.20958974793152,38.43602869962015,0.0,0,0.0
439,1959,1985,26,66,66,2025,2025,53.46742679545293,40.77678284742702,2180.229651848885,0,0.0
440,1957,1985,28,61,65,2018,2022,27.944306331873936,33.15525599313417,926.5006299838404,4,3706.0025199353618
441,1963,1985,22,63,70,2026,2033,59.87095150720391,42.00008633284983,2514.5851321324303,0,0.0
442,1960,1985,25,64,63,2024,2023,41.655932446990676,39.589109560608755,0.0,0,0.0
443,1965,1985,20,66,60,2031,2025,55.26351181303843,48.68961120403458,0.0,0,0.0
444,1959,1985,26,63,70,2022,2029,48.17588144508682,37.31653271807781,1797.7568561678202,3,5393.270568503461
445,1958,1985,27,64,62,2022,2020,35.6987434595282,37.31653271807781,0.0,0,0.0
446,1967,1985,18,60,65,2027,2032,72.35912645603294,43.26008892283532,3130.2622448666707,0,0.0
447,1959,1985,26,67,70,2026,2029,59.59906625133226,42.00008633284983,2503.165927913192,0,0.0
448,1962,1986,24,66,66,2028,2028,76.92938631669384,44.557891590520384,3427.8112556245064,0,0.0
449,1963,1986,23,64,62,2027,2025,49.59182993181859,43.26008892283532,0.0,0,0.0
450,1965,1986,21,66,65,2031,2030,94.76650980366806,48.68961120403458,0.0,0,0.0
451,1962,1986,24,64,68,2026,2030,56.02381691382057,42.00008633284983,2353.0051470762364,0,0.0
452,1967,1986,19,66,64,2033,2031,105.49421069092527,51.654808526360284,0.0,0,0.0
453,1960,1986,26,60,69,2020,2029,29.41561004295318,35.17441108311604,1034.676759911472,5,5173.383799557359
454,1967,1986,19,65,68,2032,2035,110.75236035461556,50.15029954015561,5554.264046563225,0,0.0
455,1959,1986,27,65,65,2024,2024,45.74234394101299,39.589109560608755,1810.8986658398112,0,0.0
456,1967,1986,19,61,65,2028,2032,70.14667430352586,44.557891590520384,3125.587909052047,0,0.0
457,1967,1986,19,67,64,2034,2031,100.57245823753264,53.204452782151094,0.0,0,0.0
458,1959,1986,27,64,64,2023,2023,44.37530406822138,38.43602869962015,1705.610460720528,0,0.0
459,1966,1986,20,67,62,2033,2028,71.05849611063759,51.654808526360284,0.0,0,0.0
460,1967,1986,19,66,64,2033,2031,100.8331353877434,51.654808526360284,0.0,0,0.0
461,1965,1986,21,61,66,2026,2031,57.51421649473199,42.00008633284983,2415.6020581449593,0,0.0
462,1964,1987,23,61,70,2025,2034,49.9590256458412,40.77678284742702,2037.1683400295042,0,0.0
463,1960,1987,27,64,65,2024,2025,43.409959371991434,39.589109560608755,1718.5616375993436,1,1718.5616375993436
464,1968,1987,19,66,70,2034,2038,135.63256208000308,53.204452782151094,7216.256244907701,0,0.0
465,1962,1987,25,67,67,2029,2029,79.63716797903211,45.894628338236,3654.9182263073476,0,0.0
466,1964,1987,23,60,69,2024,2033,44.3472408631458,39.589109560608755,1755.6677772417845,1,1755.6677772417845
467,1960,1987,27,62,68,2022,2028,37.28268798839786,37.31653271807781,1391.2606461369353,3,4173.781938410806
468,1960,1987,27,62,66,2022,2026,35.84018410125151,37.31653271807781,1337.431402636284,3,4012.294207908852
469,1967,1987,20,66,63,2033,2030,72.0001913048989,51.654808526360284,0.0,0,0.0
470,1959,1987,28,67,69,2026,2028,47.82349638225986,42.00008633284983,2008.5909767936457,0,0.0
471,1963,1987,24,65,70,2028,2033,62.14581319443943,44.557891590520384,2769.0864071225633,0,0.0
472,1965,1987,22,63,69,2028,2034,58.6234866782512,44.557891590520384,2612.1389640678326,0,0.0
473,1968,1987,19,62,65,2030,2033,72.04802872701175,47.271467188383085,3405.816025956618,0,0.0
474,1966,1987,21,63,63,2029,2029,74.42567114093221,45.894628338236,3415.73851583686,0,0.0
475,1967,1987,20,65,64,2032,2031,87.77905613810577,50.15029954015561,0.0,0,0.0
476,1962,1988,26,64,63,2026,2025,41.6903696070732,42.00008633284983,0.0,0,0.0
477,1966,1988,22,63,63,2029,2029,61.701647793505344,45.894628338236,2831.774193339667,0,0.0
478,1970,1988,18,61,61,2031,2031,89.12223646910053,48.68961120403458,4339.327043314536,0,0.0
479,1964,1988,24,60,62,2024,2026,39.54424598710784,39.589109560608755,1565.5214868752755,1,1565.5214868752755
480,1967,1988,21,65,62,2032,2029,66.41535755940916,50.15029954015561,0.0,0,0.0
481,1968,1988,20,66,67,2034,2035,130.38241883953512,53.204452782151094,6936.925246770694,0,0.0
482,1968,1988,20,67,61,2035,2029,61.356542802739064,54.80058636561562,0.0,0,0.0
483,1962,1988,26,65,63,2027,2025,39.48151281041831,43.26008892283532,0.0,0,0.0
484,1965,1988,23,61,62,2026,2027,43.963462767078646,42.00008633284983,1846.4692317083322,0,0.0
485,1964,1988,24,63,61,2027,2025,40.890271776838944,43.26008892283532,0.0,0,0.0
486,1968,1988,20,61,65,2029,2033,70.5343858677378,45.894628338236,3237.149424465552,0,0.0
487,1963,1988,25,61,70,2024,2033,40.77485093368719,39.589109560608755,1614.2400409312324,1,1614.2400409312324
488,1962,1988,26,63,67,2025,2029,40.91186422851674,40.77678284742702,1668.2542035296447,0,0.0
489,1963,1988,25,61,63,2024,2026,41.12217256443765,39.589109560608755,1627.9901950237816,1,1627.9901950237816
490,1971,1989,18,61,65,2032,2036,88.82247321412228,50.15029954015561,4454.47363758568,0,0.0
491,1962,1989,27,63,67,2025,2029,41.47560034513731,40.77678284742702,1691.2415487403332,0,0.0
492,1964,1989,25,61,61,2025,2025,37.63783697152968,40.77678284742702,1534.749905034926,0,0.0
493,1963,1989,26,65,63,2028,2026,41.6539546486718,44.557891590520384,0.0,0,0.0
494,1964,1989,25,61,64,2025,2028,38.097596994094225,40.77678284742702,1553.4974396369687,0,0.0
495,1968,1989,21,61,65,2029,2033,54.6688488114892,45.894628338236,2509.006497882511,0,0.0
496,1962,1989,27,65,66,2027,2028,44.84021429034746,43.26008892283532,1939.7916575194224,0,0.0
497,1970,1989,19,60,68,2030,2038,67.54281612926573,47.271467188383085,3192.8480164655766,0,0.0
498,1965,1989,24,60,70,2025,2035,38.38498065504125,40.77678284742702,1565.2160207733039,0,0.0
499,1965,1989,24,61,65,2026,2030,42.916247570295404,42.00008633284983,1802.4861030343639,0,0.0
500,1965,1989,24,66,68,2031,2033,62.79535495161471,48.68961120403458,3057.4814180134676,0,0.0
501,1968,1989,21,60,65,2028,2033,53.66240308151345,44.557891590520384,2391.0835389928834,0,0.0
502,1968,1989,21,67,68,2035,2036,115.76279479537375,54.80058636561562,6343.869034108918,0,0.0
503,1961,1989,28,65,62,2026,2023,34.03629451218239,42.00008633284983,0.0,0,0.0
504,1965,1990,25,61,61,2026,2026,38.32387219069028,42.00008633284983,1609.6059406180946,0,0.0
505,1964,1990,26,66,68,2030,2032,50.73013365030118,47.271467188383085,2398.0878483125007,0,0.0
506,1964,1990,26,67,70,2031,2034,67.90976151533987,48.68961120403458,3306.499885140608,0,0.0
507,1972,1990,18,67,70,2039,2042,129.5260628651071,61.67854274766627,7988.978805362416,0,0.0
508,1967,1990,23,67,66,2034,2033,80.38627862268585,53.204452782151094,0.0,0,0.0
509,1964,1990,26,66,64,2030,2028,44.84681963498082,47.271467188383085,0.0,0,0.0
510,1971,1990,19,64,62,2035,2033,86.04691405282337,54.80058636561562,0.0,0,0.0
511,1963,1990,27,63,63,2026,2026,41.376390918610284,42.00008633284983,1737.8119907233756,0,0.0
512,1970,1990,20,66,60,2036,2030,54.95153820491454,56.444603956584096,0.0,0,0.0
513,1966,1990,24,67,63,2033,2029,48.90947074145897,51.654808526360284,0.0,0,0.0
514,1970,1990,20,63,70,2033,2040,94.9437366892529,51.654808526360284,4904.300539460526,0,0.0
515,1964,1990,26,66,63,2030,2027,40.82124964875244,47.271467188383085,0.0,0,0.0
516,1969,1990,21,64,70,2033,2039,85.21070082141067,51.654808526360284,4401.542435326939,0,0.0
517,1964,1990,26,66,67,2030,2031,50.899720636463044,47.271467188383085,2406.104473964428,0,0.0
518,1971,1991,20,67,68,2038,2039,113.96790557565258,59.88208033754007,6824.635277582408,0,0.0
519,1965,1991,26,67,69,2032,2034,64.19034346557642,50.15029954015561,3219.1649523841274,0,0.0
520,1971,1991,20,65,60,2036,2031,54.10907885344128,56.444603956584096,0.0,0,0.0
521,1973,1991,18,63,63,2036,2036,105.32808057175312,56.444603956584096,5945.201793379784,0,0.0
522,1965,1991,26,66,64,2031,2029,44.140890280374876,48.68961120403458,0.0,0,0.0
523,1969,1991,22,67,66,2036,2035,95.25086010018119,56.444603956584096,0.0,0,0.0
524,1973,1991,18,66,69,2039,2042,128.40602005820944,61.67854274766627,7919.896197217963,0,0.0
525,1972,1991,19,65,64,2037,2036,105.1629117477959,58.13794207528162,0.0,0,0.0
526,1966,1991,25,67,61,2033,2027,37.75842965953373,51.654808526360284,0.0,0,0.0
527,1973,1991,18,66,63,2039,2036,107.89546929163168,61.67854274766627,0.0,0,0.0
528,1964,1991,27,67,62,2031,2026,36.472513526151225,48.68961120403458,0.0,0,0.0
529,1968,1991,23,63,68,2031,2036,51.97722723604144,48.68961120403458,2530.7509855866147,0,0.0
530,1971,1991,20,60,66,2031,2037,57.05415940616264,48.68961120403458,2777.944839059071,0,0.0
531,1972,1991,19,62,61,2034,2033,79.20678992457717,53.204452782151094,0.0,0,0.0
532,1968,1992,24,61,62,2029,2030,38.846306261525584,45.894628338236,1782.8367881860065,0,0.0
533,1968,1992,24,67,60,2035,2028,38.34349974648478,54.80058636561562,0.0,0,0.0
534,1970,1992,22,66,67,2036,2037,101.87370297591553,56.444603956584096,5750.220818066235,0,0.0
535,1966,1992,26,62,65,2028,2031,39.98060666848107,44.557891590520384,1781.451537657416,0,0.0
536,1968,1992,24,62,61,2030,2029,45.13696921754442,47.271467188383085,0.0,0,0.0
537,1973,1992,19,64,62,2037,2035,70.72459770424294,58.13794207528162,0.0,0,0.0
538,1966,1992,26,67,70,2033,2036,65.47449258321892,51.654808526360284,3382.0723777467697,0,0.0
539,1971,1992,21,62,67,2033,2038,65.43770836878869,51.654808526360284,3380.172296193584,0,0.0
540,1969,1992,23,66,62,2035,2031,45.136943183337735,54.80058636561562,0.0,0,0.0
541,1971,1992,21,67,70,2038,2041,114.25771536222393,59.88208033754007,6841.98969050448,0,0.0
542,1972,1992,20,66,66,2038,2038,108.35006300817898,59.88208033754007,6488.227177633302,0,0.0
543,1972,1992,20,67,64,2039,2036,97.08689803950955,61.67854274766627,0.0,0,0.0
544,1972,1992,20,60,66,2032,2038,55.52497682792706,50.15029954015561,2784.5942198807415,0,0.0
545,1967,1992,25,65,66,2032,2033,53.63018208605862,50.15029954015561,2689.569696008927,0,0.0
546,1969,1993,24,66,69,2035,2038,74.0471242826611,54.80058636561562,4057.8258293774434,0,0.0
547,1965,1993,28,65,70,2030,2035,39.191618279388486,47.271467188383085,1852.6452975537475,0,0.0
548,1972,1993,21,61,62,2033,2034,53.93901493340835,51.654808526360284,2786.2094884856965,0,0.0
549,1967,1993,26,61,61,2028,2028,36.624172385607885,44.557891590520384,1631.8959027504466,0,0.0
550,1971,1993,22,65,63,2036,2034,58.48555142896596,56.444603956584096,0.0,0,0.0
551,1973,1993,20,61,68,2034,2041,58.221280529855086,53.204452782151094,3097.6313708670477,0,0.0
552,1973,1993,20,63,65,2036,2038,82.96978639988644,56.444603956584096,4683.196733703968,0,0.0
553,1973,1993,20,61,60,2034,2033,51.011973542235566,53.204452782151094,0.0,0,0.0
554,1974,1993,19,60,68,2034,2042,56.893368815854686,53.204452782151094,3026.980554780648,0,0.0
555,1973,1993,20,61,66,2034,2039,61.96697886850733,53.204452782151094,3296.919201262053,0,0.0
556,1966,1993,27,66,64,2032,2030,39.873744426679714,50.15029954015561,0.0,0,0.0
557,1969,1993,24,61,67,2030,2036,43.661726154325166,47.271467188383085,2063.9538552923495,0,0.0
558,1966,1993,27,61,64,2027,2030,30.63913156031642,43.26008892283532,1325.4515558177386,0,0.0
559,1969,1993,24,63,63,2032,2032,47.8462626590822,50.15029954015561,2399.5044042299346,0,0.0
560,1975,1994,19,61,60,2036,2035,58.61437087150798,56.444603956584096,0.0,0,0.0
561,1974,1994,20,60,69,2034,2043,55.073566216554546,53.204452782151094,2930.158953313348,0,0.0
562,1974,1994,20,62,63,2036,2037,74.9350304883977,56.444603956584096,4229.678118392163,0,0.0
563,1972,1994,22,65,69,2037,2041,85.06175249191092,58.13794207528162,4945.31523919666,0,0.0
564,1971,1994,23,63,60,2034,2031,42.44192240766753,53.204452782151094,0.0,0,0.0
565,1968,1994,26,66,63,2034,2031,44.87833224374969,53.204452782151094,0.0,0,0.0
566,1975,1994,19,64,68,2039,2043,101.41518116952828,61.67854274766627,6255.140587027069,0,0.0
567,1972,1994,22,62,64,2034,2036,53.213160492165244,53.204452782151094,2831.177084794434,0,0.0
568,1967,1994,27,61,60,2028,2027,29.307422181200685,44.557891590520384,0.0,0,0.0
569,1968,1994,26,60,62,2028,2030,33.026931679208815,44.557891590520384,1471.6104413297098,0,0.0
570,1970,1994,24,62,65,2032,2035,43.59289903538619,50.15029954015561,2186.196944448378,0,0.0
571,1975,1994,19,61,62,2036,2037,73.90383342518848,56.444603956584096,4171.472608558126,0,0.0
572,1967,1994,27,62,63,2029,2030,34.97255273964786,45.894628338236,1605.0523100254957,0,0.0
573,1976,1994,18,62,61,2038,2037,82.31948308611999,59.88208033754007,0.0,0,0.0
574,1967,1995,28,60,67,2027,2034,21.48362096463838,43.26008892283532,929.3833533147455,0,0.0
575,1971,1995,24,62,65,2033,2036,47.28901762468539,51.654808526360284,2442.7051508028007,0,0.0
576,1967,1995,28,67,68,2034,2035,46.09078204289345,53.204452782151094,2452.2348368935423,0,0.0
577,1970,1995,25,61,64,2031,2034,36.9538671492073,48.68961120403458,1799.269423980449,0,0.0
578,1970,1995,25,60,60,2030,2030,33.95512617563562,47.271467188383085,1605.108632888967,0,0.0
579,1969,1995,26,64,61,2033,2030,34.88355527703337,51.654808526360284,0.0,0,0.0
580,1975,1995,20,62,66,2037,2041,80.49091482837022,58.13794207528162,4679.576143878215,0,0.0
581,1974,1995,21,66,61,2040,2035,53.69223851219462,63.52889903009626,0.0,0,0.0
582,1976,1995,19,65,64,2041,2040,100.18862943852018,65.43476600099916,0.0,0,0.0
583,1976,1995,19,65,69,2041,2045,114.58107777375871,65.43476600099916,7497.586012268187,0,0.0
584,1968,1995,27,67,63,2035,2031,40.13549142926566,54.80058636561562,0.0,0,0.0
585,1970,1995,25,63,70,2033,2040,51.926846800680146,51.654808526360284,2682.271328866777,0,0.0
586,1971,1995,24,60,69,2031,2040,37.194080566120064,48.68961120403458,1810.9653218559242,0,0.0
587,1976,1995,19,62,60,2038,2036,61.452342444780925,59.88208033754007,0.0,0,0.0
588,1974,1996,22,60,63,2034,2037,49.055680386253385,53.204452782151094,2609.9806308067136,0,0.0
589,1976,1996,20,63,65,2039,2041,82.19031595262138,61.67854274766627,5069.378915927955,0,0.0
590,1976,1996,20,60,65,2036,2041,54.33865186836519,56.444603956584096,3067.1236842445715,0,0.0
591,1970,1996,26,67,64,2037,2034,44.12497776118062,58.13794207528162,0.0,0,0.0
592,1969,1996,27,67,68,2036,2037,52.46569399076629,56.444603956584096,2961.4053186161373,0,0.0
593,1977,1996,19,67,67,2044,2044,143.3252501022159,71.5023355479738,10248.090125305907,0,0.0
594,1972,1996,24,60,69,2032,2041,40.52194931415568,50.15029954015561,2032.1878960559102,0,0.0
595,1972,1996,24,64,64,2036,2036,58.28190978901928,56.444603956584096,3289.699315874555,0,0.0
596,1970,1996,26,63,70,2033,2040,41.262478696571485,51.654808526360284,2131.40543639442,0,0.0
597,1969,1996,27,66,63,2035,2032,35.965972391551084,54.80058636561562,0.0,0,0.0
598,1975,1996,21,63,67,2038,2042,67.71850363086634,59.88208033754007,4055.124874761537,0,0.0
599,1970,1996,26,65,66,2035,2036,46.775041469888116,54.80058636561562,2563.299699825856,0,0.0
600,1971,1996,25,61,66,2032,2037,37.840466460721764,50.15029954015561,1897.7107277444084,0,0.0
601,1969,1996,27,66,61,2035,2030,29.69285004427469,54.80058636561562,0.0,0,0.0
602,1973,1997,24,63,67,2036,2040,55.607998276868,56.444603956584096,3138.7714395562252,0,0.0
603,1977,1997,20,62,64,2039,2041,72.28137364522681,61.67854274766627,4458.20979423716,0,0.0
604,1973,1997,24,65,60,2038,2033,39.44409824337978,59.88208033754007,0.0,0,0.0
605,1969,1997,28,60,64,2029,2033,26.438299446591724,45.894628338236,1213.3759269963175,0,0.0
606,1970,1997,27,64,60,2034,2030,28.920592660415956,53.204452782151094,0.0,0,0.0
607,1973,1997,24,63,67,2036,2040,49.795911110046276,56.444603956584096,2810.710481263828,0,0.0
608,1977,1997,20,64,65,2041,2042,89.16522858041279,65.43476600099916,5834.505867584913,0,0.0
609,1973,1997,24,64,67,2037,2040,51.77048094185786,58.13794207528162,3009.8292222072037,0,0.0
610,1969,1997,28,66,70,2035,2039,51.54042736039389,54.80058636561562,2824.4456408840038,0,0.0
611,1970,1997,27,61,68,2031,2038,34.80294908644524,48.68961120403458,1694.5420597728291,0,0.0
612,1972,1997,25,61,60,2033,2032,35.70212391243082,51.654808526360284,0.0,0,0.0
613,1975,1997,22,63,67,2038,2042,63.30538127331844,59.88208033754007,3790.8579272074594,0,0.0
614,1974,1997,23,60,69,2034,2043,39.87301041294957,53.204452782151094,2121.4216997979943,0,0.0
615,1978,1997,19,63,70,2041,2048,90.20617015488283,65.43476600099916,5902.6196359310725,0,0.0
616,1979,1998,19,62,68,2041,2047,83.84392388491479,65.43476600099916,5486.307540014984,0,0.0
617,1971,1998,27,66,62,2037,2033,34.10858961042147,58.13794207528162,0.0,0,0.0
618,1970,1998,28,61,61,2031,2031,25.62404481895607,48.68961120403458,1247.6247797097276,0,0.0
619,1978,1998,20,61,64,2039,2042,66.52794185533186,61.67854274766627,4103.346505638342,0,0.0
620,1975,1998,23,67,62,2042,2037,50.1525129392915,67.39780898102913,0.0,0,0.0
621,1977,1998,21,63,66,2040,2043,76.23240805817092,63.52889903009626,4842.960954348637,0,0.0
622,1972,1998,26,65,60,2037,2032,33.047942652862446,58.13794207528162,0.0,0,0.0
623,1975,1998,23,66,68,2041,2043,84.44432686787262,65.43476600099916,5525.594768711131,0,0.0
624,1975,1998,23,63,64,2038,2039,56.008181665250994,59.88208033754007,3353.8864340380987,0,0.0
625,1980,1998,18,66,60,2046,2040,74.37544571909804,75.85682778284541,0.0,0,0.0
626,1973,1998,25,64,64,2037,2037,41.83683687164736,58.13794207528162,2432.3075986568406,0,0.0
627,1980,1998,18,66,66,2046,2046,129.06596149753406,75.85682778284541,9790.534413945797,0,0.0
628,1975,1998,23,67,68,2042,2043,88.03361918126244,67.39780898102913,5933.273049487388,0,0.0
629,1974,1998,24,62,63,2036,2037,53.31840925624413,56.444603956584096,3009.5364940637673,0,0.0
630,1978,1999,21,61,66,2039,2044,58.219557134083225,61.67854274766627,3590.897443444751,0,0.0
631,1976,1999,23,66,65,2042,2041,79.2512597679165,67.39780898102913,0.0,0,0.0
632,1980,1999,19,67,63,2047,2043,91.78101115201167,78.13253261633078,0.0,0,0.0
633,1979,1999,20,64,66,2043,2045,92.7928593554213,69.41974325046002,6441.656471929393,0,0.0
634,1975,1999,24,65,69,2040,2044,61.274318203677026,63.52889903009626,3892.6899742993874,0,0.0
635,1980,1999,19,65,68,2045,2048,111.04696357094038,73.64740561441303,8178.320768357994,0,0.0
636,1977,1999,22,63,68,2040,2045,62.40751682612351,63.52889903009626,3964.680835165834,0,0.0
637,1978,1999,21,60,68,2038,2046,51.84765835833251,59.88208033754007,3104.745643126998,0,0.0
638,1973,1999,26,61,64,2034,2037,36.58652123884642,53.204452782151094,1946.5658417153727,0,0.0
639,1980,1999,19,65,62,2045,2042,83.4669541154704,73.64740561441303,0.0,0,0.0
640,1977,1999,22,66,62,2043,2039,53.60462190509147,69.41974325046002,0.0,0,0.0
641,1976,1999,23,61,65,2037,2041,49.532298533989454,58.13794207528162,2879.7059030246355,0,0.0
642,1979,1999,20,63,62,2042,2041,71.45770606855423,67.39780898102913,0.0,0,0.0
643,1973,1999,26,65,67,2038,2040,47.03982809179091,59.88208033754007,2816.842764856697,0,0.0
644,1979,2000,21,64,63,2043,2042,75.45417539830486,69.41974325046002,0.0,0,0.0
645,1977,2000,23,65,66,2042,2043,69.1250971767715,67.39780898102913,4658.880095315122,0,0.0
646,1981,2000,19,66,63,2047,2044,87.11447917710719,78.13253261633078,0.0,0,0.0
647,1972,2000,28,61,62,2033,2034,29.174765014309376,51.654808526360284,1507.0169006157057,0,0.0
648,1979,2000,21,60,62,2039,2041,48.17379931560922,61.67854274766627,2971.2897404052997,0,0.0
649,1980,2000,20,66,69,2046,2049,111.69977401593867,75.85682778284541,8473.190520909811,0,0.0
650,1978,2000,22,67,62,2045,2040,54.08754351381299,73.64740561441303,0.0,0,0.0
651,1976,2000,24,60,61,2036,2037,44.15220032357902,56.444603956584096,2492.153461076182,0,0.0
652,1978,2000,22,60,64,2038,2042,42.02375932801683,59.88208033754007,2516.4701321657526,0,0.0
653,1982,2000,18,64,60,2046,2042,77.24890681803305,75.85682778284541,0.0,0,0.0
654,1981,2000,19,60,62,2041,2043,57.846427950783124,65.43476600099916,3785.167476953151,0,0.0
655,1980,2000,20,61,68,2041,2048,65.63739635115712,65.43476600099916,4294.967671152803,0,0.0
656,1981,2000,19,63,64,2044,2045,92.64691994345877,71.5023355479738,6624.471157283455,0,0.0
657,1975,2000,25,67,64,2042,2039,49.10326305706237,67.39780898102913,0.0,0,0.0
658,1982,2001,19,61,70,2043,2052,76.26319122806451,69.41974325046002,5294.171154512973,0,0.0
659,1974,2001,27,63,64,2037,2038,42.93219067206063,58.13794207528162,2495.989214457207,0,0.0
660,1975,2001,26,65,63,2040,2038,40.43091120355663,63.52889903009626,0.0,0,0.0
661,1982,2001,19,61,70,2043,2052,70.17237159867177,69.41974325046002,4871.348019655667,0,0.0
662,1977,2001,24,66,63,2043,2040,50.98359970418196,69.41974325046002,0.0,0,0.0
663,1981,2001,20,62,68,2043,2049,70.56378799416117,69.41974325046002,4898.5200453345615,0,0.0
664,1981,2001,20,65,69,2046,2050,97.61932515048335,75.85682778284541,7405.0923362178055,0,0.0
665,1977,2001,24,66,60,2043,2037,39.85269825642831,69.41974325046002,0.0,0,0.0
666,1974,2001,27,62,60,2036,2034,28.941447155824086,56.444603956584096,0.0,0,0.0
667,1977,2001,24,65,69,2042,2046,59.036755761273106,67.39780898102913,3978.9479876579558,0,0.0
668,1977,2001,24,64,67,2041,2044,52.33541866004414,65.43476600099916,3424.5558735843133,0,0.0
669,1975,2001,26,64,68,2039,2043,44.42737672734288,61.67854274766627,2740.2158546440915,0,0.0
670,1975,2001,26,62,70,2037,2045,41.00671459332164,58.13794207528162,2384.045997724139,0,0.0
671,1973,2001,28,67,62,2040,2035,27.75437480723758,63.52889903009626,0.0,0,0.0
672,1984,2002,18,60,63,2044,2047,78.42232791031259,71.5023355479738,5607.379604696402,0,0.0
673,1974,2002,28,66,65,2040,2039,42.8009005997384,63.52889903009626,0.0,0,0.0
674,1980,2002,22,67,66,2047,2046,92.11639292729328,78.13253261633078,0.0,0,0.0
675,1982,2002,20,60,61,2042,2043,51.65774713832932,67.39780898102913,3481.6189740194236,0,0.0
676,1981,2002,21,60,69,2041,2050,49.34436750156118,65.43476600099916,3228.8371409319634,0,0.0
677,1983,2002,19,63,67,2046,2050,81.4635954920229,75.85682778284541,6179.569933809764,0,0.0
678,1984,2002,18,60,66,2044,2050,66.88236092473986,71.5023355479738,4782.24501308144,0,0.0
679,1984,2002,18,66,64,2050,2048,109.53523611664255,85.37752796824529,0.0,0,0.0
680,1977,2002,25,66,61,2043,2038,40.25105896703236,69.41974325046002,0.0,0,0.0
681,1975,2002,27,60,63,2035,2038,25.006290387104976,54.80058636561562,1370.35937604221,0,0.0
682,1978,2002,24,66,65,2044,2043,60.04798457786039,71.5023355479738,0.0,0,0.0
683,1975,2002,27,62,69,2037,2044,32.09015211197248,58.13794207528162,1865.6554046728322,0,0.0
684,1977,2002,25,67,68,2044,2045,71.60184898471492,71.5023355479738,5119.699431960434,0,0.0
685,1975,2002,27,67,60,2042,2035,27.787930320480093,67.39780898102913,0.0,0,0.0
686,1981,2003,22,65,68,2046,2049,87.01262254597665,75.85682778284541,6600.501523403883,0,0.0
687,1982,2003,21,67,63,2049,2045,77.46238015152242,82.89080385266533,0.0,0,0.0
688,1977,2003,26,67,67,2044,2044,60.406097920885664,71.5023355479738,4319.177082682929,0,0.0
689,1978,2003,25,63,61,2041,2039,40.338862255988964,65.43476600099916,0.0,0,0.0
690,1981,2003,22,64,61,2045,2042,47.54936839851764,73.64740561441303,0.0,0,0.0
691,1981,2003,22,60,68,2041,2049,46.672263416202696,65.43476600099916,3053.988635376217,0,0.0
692,1982,2003,21,65,62,2047,2044,62.89307660299856,78.13253261633078,0.0,0,0.0
693,1983,2003,20,66,65,2049,2048,109.21714190625305,82.89080385266533,0.0,0,0.0
694,1975,2003,28,63,61,2038,2036,28.019122706396352,59.88208033754007,0.0,0,0.0
695,1977,2003,26,65,64,2042,2041,45.57655964615045,67.39780898102913,0.0,0,0.0
696,1982,2003,21,66,65,2048,2047,90.77662493369454,80.4765085948207,0.0,0,0.0
697,1979,2003,24,61,67,2040,2046,43.52017950858386,63.52889903009626,2764.7890897724883,0,0.0
698,1976,2003,27,67,61,2043,2037,29.00607481949451,69.41974325046002,0.0,0,0.0
699,1979,2003,24,63,66,2042,2045,49.20150287811032,67.39780898102913,3316.0734925584343,0,0.0
700,1982,2004,22,67,69,2049,2051,108.22660306143177,82.89080385266533,8970.99012600541,0,0.0
701,1978,2004,26,67,69,2045,2047,57.42286510313062,73.64740561441303,4229.045037791984,0,0.0
702,1982,2004,22,61,63,2043,2045,46.255246694490786,69.41974325046002,3211.0273495182396,0,0.0
703,1981,2004,23,65,60,2046,2041,43.97861988878647,75.85682778284541,0.0,0,0.0
704,1976,2004,28,61,61,2037,2037,28.7973005546707,58.13794207528162,1674.2157915719204,0,0.0
705,1984,2004,20,61,65,2045,2049,56.26658518415822,73.64740561441303,4143.888021595623,0,0.0
706,1984,2004,20,63,61,2047,2045,64.41739232929291,78.13253261633078,0.0,0,0.0
707,1980,2004,24,63,62,2043,2042,43.88600177293858,69.41974325046002,0.0,0,0.0
708,1984,2004,20,62,61,2046,2045,57.251012163596016,75.85682778284541,0.0,0,0.0
709,1977,2004,27,64,65,2041,2042,45.09551058954608,65.43476600099916,2950.8141831225275,0,0.0
710,1984,2004,20,67,60,2051,2044,57.91337363915628,87.93885380729265,0.0,0,0.0
711,1976,2004,28,64,61,2040,2037,26.945014205570686,63.52889903009626,0.0,0,0.0
712,1976,2004,28,60,67,2036,2043,26.207569695208118,56.444603956584096,1479.2758921105976,0,0.0
713,1980,2004,24,63,63,2043,2043,49.29714398235594,69.41974325046002,3422.1950782361096,0,0.0
714,1987,2005,18,66,70,2053,2057,138.41592171635654,93.29433000415678,12913.420678435297,0,0.0
715,1985,2005,20,61,65,2046,2050,60.088598376772126,75.85682778284541,4558.1304587793675,0,0.0
716,1979,2005,26,65,62,2044,2041,39.36973211413109,71.5023355479738,0.0,0,0.0
717,1981,2005,24,64,60,2045,2041,32.470305601627025,73.64740561441303,0.0,0,0.0
718,1987,2005,18,64,65,2051,2052,105.96376193412183,87.93885380729265,9318.331769595501,0,0.0
719,1982,2005,23,63,65,2045,2047,56.61988883279644,73.64740561441303,4169.907918711934,0,0.0
720,1985,2005,20,61,62,2046,2047,73.60875263841486,75.85682778284541,5583.726472202304,0,0.0
721,1982,2005,23,64,60,2046,2042,43.166745960667576,75.85682778284541,0.0,0,0.0
722,1984,2005,21,66,65,2050,2049,93.80443591673665,85.37752796824529,0.0,0,0.0
723,1984,2005,21,64,68,2048,2052,67.94401884912533,80.4765085948207,5467.897416878294,0,0.0
724,1983,2005,22,64,63,2047,2046,61.742274963442775,78.13253261633078,0.0,0,0.0
725,1984,2005,21,67,65,2051,2049,84.49332946910921,87.93885380729265,0.0,0,0.0
726,1985,2005,20,67,63,2052,2048,84.72938433020536,90.57701942151144,0.0,0,0.0
727,1977,2005,28,62,68,2039,2045,32.217314033822014,61.67854274766627,1987.1169808500795,0,0.0
728,1983,2006,23,65,68,2048,2051,69.25564475943071,80.4765085948207,5573.452490722175,0,0.0
729,1981,2006,25,65,68,2046,2049,56.312889334333924,75.85682778284541,4271.717148189001,0,0.0
730,1985,2006,21,60,60,2045,2045,47.3447511766007,73.64740561441303,3486.8180936165704,0,0.0
731,1984,2006,22,66,60,2050,2044,49.4199015221414,85.37752796824529,0.0,0,0.0
732,1981,2006,25,61,66,2042,2047,38.81308465598063,67.39780898102913,2615.916865608295,0,0.0
733,1985,2006,21,60,63,2045,2048,46.825347287627814,73.64740561441303,3448.565344727681,0,0.0
734,1985,2006,21,65,63,2050,2048,68.7002176493296,85.37752796824529,0.0,0,0.0
735,1979,2006,27,60,68,2039,2047,32.400063255022474,61.67854274766627,1998.3886865019947,0,0.0
736,1982,2006,24,60,66,2042,2048,34.03766685888054,67.39780898102913,2294.0641691147366,0,0.0
737,1982,2006,24,62,69,2044,2051,51.43876582130938,71.5023355479738,3677.9918939289096,0,0.0
738,1985,2006,21,67,60,2052,2045,50.78293241671408,90.57701942151144,0.0,0,0.0
739,1982,2006,24,67,66,2049,2048,68.14687206235757,82.89080385266533,0.0,0,0.0
740,1988,2006,18,64,63,2052,2051,102.97247115294346,90.57701942151144,0.0,0,0.0
741,1987,2006,19,64,69,2051,2056,94.98283455700333,87.93885380729265,8352.68160231058,0,0.0
742,1985,2007,22,61,63,2046,2048,50.40755596517913,75.85682778284541,3823.7572918047354,0,0.0
743,1983,2007,24,66,62,2049,2045,42.64280330601374,82.89080385266533,0.0,0,0.0
744,1985,2007,22,64,66,2049,2051,74.26224221003598,82.89080385266533,6155.656952691216,0,0.0
745,1985,2007,22,67,65,2052,2050,80.9524695723294,90.57701942151144,0.0,0,0.0
746,1988,2007,19,60,69,2048,2057,61.791678321295734,80.4765085948207,4972.778531512152,0,0.0
747,1982,2007,25,62,64,2044,2046,47.35156167736198,71.5023355479738,3385.747251775313,0,0.0
748,1979,2007,28,61,66,2040,2045,29.737863692883373,63.52889903009626,1889.2137399159533,0,0.0
749,1984,2007,23,66,62,2050,2046,48.457390191799504,85.37752796824529,0.0,0,0.0
750,1982,2007,25,65,65,2047,2047,54.168527311206056,78.13253261633078,4232.3242269214115,0,0.0
751,1986,2007,21,61,61,2047,2047,52.45450727878252,78.13253261633078,4098.403500833036,0,0.0
752,1983,2007,24,64,65,2047,2048,49.866756673396736,78.13253261633078,3896.2159922548008,0,0.0
753,1979,2007,28,65,69,2044,2048,43.593249103775506,71.5023355479738,3117.019125044564,0,0.0
754,1983,2007,24,63,63,2046,2046,54.09343404202574,75.85682778284541,4103.356310308654,0,0.0
755,1988,2007,19,65,63,2053,2051,101.30730241073954,93.29433000415678,0.0,0,0.0
756,1981,2008,27,64,60,2045,2041,25.342159949619976,73.64740561441303,0.0,0,0.0
757,1989,2008,19,63,64,2052,2053,88.70499553517391,90.57701942151144,8034.634103374532,0,0.0
758,1990,2008,18,63,66,2053,2056,112.26257814720888,93.29433000415678,10473.462012783144,0,0.0
759,1986,2008,22,66,61,2052,2047,44.98289163467048,90.57701942151144,0.0,0,0.0
760,1990,2008,18,64,69,2054,2059,109.56905140663127,96.09315990428149,10528.836377377858,0,0.0
761,1987,2008,21,62,62,2049,2049,63.1616610235859,82.89080385266533,5235.5208549145955,0,0.0
762,1990,2008,18,67,60,2057,2050,72.59912277663699,105.0035903427258,0.0,0,0.0
763,1990,2008,18,63,63,2053,2053,102.60103678347808,93.29433000415678,9572.094984446432,0,0.0
764,1985,2008,23,65,64,2050,2049,62.761927451619705,85.37752796824529,0.0,0,0.0
765,1990,2008,18,60,60,2050,2050,62.70914841150777,85.37752796824529,5353.952072368349,0,0.0
766,1988,2008,20,65,66,2053,2054,110.06684392489105,93.29433000415678,10268.612459644804,0,0.0
767,1983,2008,25,67,61,2050,2044,40.50423614825179,85.37752796824529,0.0,0,0.0
768,1987,2008,21,60,65,2047,2052,51.24765808972117,78.13253261633078,4004.109317205707,0,0.0
769,1988,2008,20,62,70,2050,2058,71.43965021791661,85.37752796824529,6099.340734521836,0,0.0
770,1981,2009,28,61,70,2042,2051,29.389742543492595,67.39780898102913,1980.804253947939,0,0.0
771,1987,2009,22,65,68,2052,2055,82.32483310438094,90.57701942151144,7456.7380069682,0,0.0
772,1989,2009,20,66,60,2055,2049,53.081247414333966,98.97595470140993,0.0,0,0.0
773,1982,2009,27,62,63,2044,2045,35.48585550609027,71.5023355479738,2537.3215476033797,0,0.0
774,1985,2009,24,63,66,2048,2051,52.50242984712073,80.4765085948207,4225.212246840782,0,0.0
775,1982,2009,27,66,62,2048,2044,35.65998626874362,80.4765085948207,0.0,0,0.0
776,1984,2009,25,60,61,2044,2045,33.4946901060363,71.5023355479738,2394.948571037206,0,0.0
777,1987,2009,22,65,70,2052,2057,86.80764386950317,90.57701942151144,7862.777644703637,0,0.0
778,1989,2009,20,66,60,2055,2049,58.24954092397417,98.97595470140993,0.0,0,0.0
779,1986,2009,23,65,63,2051,2049,50.647078364333616,87.93885380729265,0.0,0,0.0
780,1987,2009,22,61,65,2048,2052,44.635884692027815,80.4765085948207,3592.140158055402,0,0.0
781,1988,2009,21,61,68,2049,2056,54.60035990277022,82.89080385266533,4525.867722985459,0,0.0
782,1981,2009,28,62,67,2043,2048,34.27116936086644,69.41974325046002,2379.09577792438,0,0.0
783,1988,2009,21,67,60,2055,2048,49.13905947941737,98.97595470140993,0.0,0,0.0
784,1992,2010,18,62,60,2054,2052,69.8204399967277,96.09315990428149,0.0,0,0.0
785,1986,2010,24,64,63,2050,2049,50.611632921493346,85.37752796824529,0.0,0,0.0
786,1983,2010,27,61,69,2044,2052,28.503528624400612,71.5023355479738,2038.0688680031687,0,0.0
787,1987,2010,23,67,62,2054,2049,45.291428530264206,96.09315990428149,0.0,0,0.0
788,1987,2010,23,67,69,2054,2056,90.70650930509184,96.09315990428149,8716.275103013388,0,0.0
789,1992,2010,18,67,64,2059,2056,109.91531261144695,111.39830899459781,0.0,0,0.0
790,1989,2010,21,60,69,2049,2058,46.31089782523439,82.89080385266533,3838.7475478723295,0,0.0
791,1986,2010,24,64,64,2050,2050,59.14495789333972,85.37752796824529,5049.650296719302,0,0.0
792,1982,2010,28,62,65,2044,2047,31.953852141921196,71.5023355479738,2284.7750579019907,0,0.0
793,1985,2010,25,63,63,2048,2048,49.244377487731704,80.4765085948207,3963.0155681380356,0,0.0
794,1987,2010,23,60,63,2047,2050,43.64090169305223,78.13253261633078,3409.774174938488,0,0.0
795,1992,2010,18,60,64,2052,2056,68.72131631741928,90.57701942151144,6224.572002754717,0,0.0
796,1983,2010,27,62,61,2045,2044,31.81109621890683,73.64740561441303,0.0,0,0.0
797,1991,2010,19,65,68,2056,2059,115.34992260387492,101.94523334245224,11759.374775885835,0,0.0
798,1993,2011,18,60,61,2053,2054,75.27980944699807,93.29433000415678,7023.1793851982775,0,0.0
799,1984,2011,27,60,70,2044,2054,27.120887717914623,71.5023355479738,1939.2068139652529,0,0.0
800,1984,2011,27,64,62,2048,2046,33.40930471113943,80.4765085948207,0.0,0,0.0
801,1983,2011,28,65,63,2048,2046,34.54534182851125,80.4765085948207,0.0,0,0.0
802,1985,2011,26,61,68,2046,2053,37.96216730890173,75.85682778284541,2879.689587814923,0,0.0
803,1986,2011,25,66,68,2052,2054,67.20770424335362,90.57701942151144,6087.473532525437,0,0.0
804,1988,2011,23,65,69,2053,2057,64.61722881457807,93.29433000415678,6028.421068981354,0,0.0
805,1983,2011,28,61,60,2044,2043,25.55836996496059,71.5023355479738,0.0,0,0.0
806,1992,2011,19,66,68,2058,2060,119.58389587020793,108.15369805300759,12933.44056594877,0,0.0
807,1989,2011,22,66,61,2055,2050,50.72483133119643,98.97595470140993,0.0,0,0.0
808,1985,2011,26,62,61,2047,2046,36.540561353284005,78.13253261633078,0.0,0,0.0
809,1991,2011,20,62,67,2053,2058,76.57177033875678,93.29433000415678,7143.712010986478,0,0.0
810,1986,2011,25,66,67,2052,2053,63.6729208319987,90.57701942151144,5767.3033868243065,0,0.0
811,1985,2011,26,63,62,2048,2047,40.02447615615883,80.4765085948207,0.0,0,0.0
812,1986,2012,26,67,60,2053,2046,29.0381282970731,93.29433000415678,0.0,0,0.0
813,1990,2012,22,61,70,2051,2060,44.76105371748871,87.93885380729265,3936.2357591226123,0,0.0
814,1992,2012,20,61,67,2053,2059,60.51459352905157,93.29433000415678,5645.668458766747,0,0.0
815,1989,2012,23,61,68,2050,2057,48.1796432970012,85.37752796824529,4113.458843089801,0,0.0
816,1992,2012,20,66,69,2058,2061,99.8396074769925,108.15369805300759,10798.022760797445,0,0.0
817,1985,2012,27,61,63,2046,2048,28.42951942234244,75.85682778284541,2156.5731587696896,0,0.0
818,1994,2012,18,67,64,2061,2058,125.1665241393925,118.18246601236882,0.0,0,0.0
819,1994,2012,18,65,68,2059,2062,136.16223584600462,111.39830899459781,15168.242822168526,0,0.0
820,1985,2012,27,61,62,2046,2047,33.126722198613706,75.85682778284541,2512.888060830402,0,0.0
821,1985,2012,27,67,67,2052,2052,51.47097404137365,90.57701942151144,4662.087415389612,0,0.0
822,1992,2012,20,64,70,2056,2062,92.28348345789318,101.94523334245224,9407.861254769252,0,0.0
823,1994,2012,18,60,64,2054,2058,73.21078154904731,96.09315990428149,7035.055338110024,0,0.0
824,1994,2012,18,64,69,2058,2063,102.25305446046136,108.15369805300759,11059.045977114478,0,0.0
825,1988,2012,24,67,68,2055,2056,85.40735187362547,98.97595470140993,8453.274190211334,0,0.0
826,1986,2013,27,61,67,2047,2053,29.69674137557271,78.13253261633078,2320.2816141256744,0,0.0
827,1993,2013,20,61,69,2054,2062,62.31846260604694,96.09315990428149,5988.377992191856,0,0.0
828,1992,2013,21,61,63,2053,2055,51.404107707474665,93.29433000415678,4795.71178803036,0,0.0
829,1985,2013,28,61,69,2046,2054,30.943270622430823,75.85682778284541,2347.258350643715,0,0.0
830,1991,2013,22,67,61,2058,2052,51.97095951065415,108.15369805300759,0.0,0,0.0
831,1989,2013,24,64,65,2053,2054,54.025649455013685,93.29433000415678,5040.2867689449395,0,0.0
832,1987,2013,26,67,64,2054,2051,49.75776502636981,96.09315990428149,0.0,0,0.0
833,1995,2013,18,65,69,2060,2064,103.09041421132865,114.74025826443574,11828.620751195505,0,0.0
834,1991,2013,22,63,64,2054,2055,57.13750260608993,96.09315990428149,5490.523174458301,0,0.0
835,1988,2013,25,64,65,2052,2053,49.25008740846702,90.57701942151144,4460.926123707853,0,0.0
836,1988,2013,25,62,60,2050,2048,32.78572608295842,85.37752796824529,0.0,0,0.0
837,1991,2013,22,62,66,2053,2057,54.440820668848914,93.29433000415678,5079.0198891767095,0,0.0
838,1987,2013,26,61,68,2048,2055,33.924918282790024,80.4765085948207,2730.1589777635413,0,0.0
839,1988,2013,25,60,69,2048,2057,37.4977095426491,80.4765085948207,3017.6847442950902,0,0.0
840,1990,2014,24,66,60,2056,2050,36.729572119948315,101.94523334245224,0.0,0,0.0
841,1986,2014,28,65,60,2051,2046,23.60190091456829,87.93885380729265,0.0,0,0.0
842,1988,2014,26,66,63,2054,2051,41.04442757240417,96.09315990428149,0.0,0,0.0
843,1993,2014,21,64,65,2057,2058,76.0207787668019,105.0035903427258,7982.454711164254,0,0.0
844,1995,2014,19,60,67,2055,2062,63.536689959397,98.97595470140993,6288.604547298805,0,0.0
845,1988,2014,26,63,69,2051,2057,46.46588047075665,87.93885380729265,4086.1562697450036,0,0.0
846,1986,2014,28,64,70,2050,2056,40.78960587150632,85.37752796824529,3482.515716108233,0,0.0
847,1992,2014,22,67,61,2059,2053,52.97866234004451,111.39830899459781,0.0,0,0.0
848,1996,2014,18,65,68,2061,2064,118.8752072943597,118.18246601236882,14048.965145778962,0,0.0
849,1993,2014,21,67,62,2060,2055,67.6961181903813,114.74025826443574,0.0,0,0.0
850,1988,2014,26,67,64,2055,2052,44.43872209374063,98.97595470140993,0.0,0,0.0
851,1989,2014,25,62,65,2051,2054,42.605133240798274,87.93885380729265,3746.646583502784,0,0.0
852,1993,2014,21,60,66,2053,2059,51.03327929092975,93.29433000415678,4761.1155993623,0,0.0
853,1988,2014,26,64,69,2052,2057,49.43354940887298,90.57701942151144,4477.543564881733,0,0.0
854,1997,2015,18,63,70,2060,2067,93.18043163913552,114.74025826443574,10691.54679146601,0,0.0
855,1991,2015,24,62,63,2053,2054,47.19659012243784,93.29433000415678,4403.174253953642,0,0.0
856,1997,2015,18,60,69,2057,2066,72.18298954608579,105.0035903427258,7579.473064010452,0,0.0
857,1987,2015,28,61,65,2048,2052,26.871830909067864,80.4765085948207,2162.5511311121686,0,0.0
858,1988,2015,27,60,60,2048,2048,26.717756621418342,80.4765085948207,2150.151770377901,0,0.0
859,1997,2015,18,65,65,2062,2062,110.24598973343,121.72793999273989,13420.017222711185,0,0.0
860,1990,2015,25,64,60,2054,2050,35.692348259031476,96.09315990428149,0.0,0,0.0
861,1991,2015,24,60,63,2051,2054,38.64423969378166,87.93885380729265,3398.3301449254404,0,0.0
862,1987,2015,28,64,65,2051,2052,36.6556166167947,87.93885380729265,3223.4529108804763,0,0.0
863,1988,2015,27,63,70,2051,2058,35.272410005156445,87.93885380729265,3101.815306874339,0,0.0
864,1997,2015,18,67,70,2064,2067,128.24860638878496,129.14117153829775,16562.17527720171,0,0.0
865,1988,2015,27,63,62,2051,2050,37.81818642529726,87.93885380729265,0.0,0,0.0
866,1990,2015,25,67,60,2057,2050,35.251354950922554,105.0035903427258,0.0,0,0.0
867,1994,2015,21,65,70,2059,2064,98.34991237396294,111.39830899459781,10956.013928226343,0,0.0
868,1994,2016,22,61,70,2055,2064,47.62189066093947,98.97595470140993,4713.422092852642,0,0.0
869,1993,2016,23,62,70,2055,2063,50.16622872294871,98.97595470140993,4965.250381623141,0,0.0
870,1991,2016,25,63,63,2054,2054,49.91258056161487,96.09315990428149,4796.25758514259,0,0.0
871,1990,2016,26,64,64,2054,2054,50.59348097905973,96.09315990428149,4861.687457835011,0,0.0
872,1994,2016,22,60,63,2054,2057,51.61621051315703,96.09315990428149,4959.964770493853,0,0.0
873,1988,2016,28,62,67,2050,2055,33.60097261778208,85.37752796824529,2868.7679794349333,0,0.0
874,1990,2016,26,60,60,2050,2050,33.27972222317633,85.37752796824529,2841.340414884671,0,0.0
875,1991,2016,25,64,64,2055,2055,44.92630924323157,98.97595470140993,4446.624348559622,0,0.0
876,1992,2016,24,64,69,2056,2061,50.196114604603196,101.94523334245224,5117.254616250748,0,0.0
877,1990,2016,26,65,62,2055,2052,41.249509070123096,98.97595470140993,0.0,0,0.0
878,1993,2016,23,64,63,2057,2056,53.16187209425041,105.0035903427258,0.0,0,0.0
879,1991,2016,25,62,70,2053,2061,38.97277540794521,93.29433000415678,3635.938970086726,0,0.0
880,1994,2016,22,64,63,2058,2057,63.92382460410578,108.15369805300759,0.0,0,0.0
881,1988,2016,28,61,68,2049,2056,29.173638482253367,82.89080385266533,2418.2263451010326,0,0.0
882,1989,2017,28,62,67,2051,2056,29.064107884914016,87.93885380729265,2555.864334330835,0,0.0
883,1995,2017,22,65,63,2060,2058,58.57806767985023,114.74025826443574,0.0,0,0.0
884,1989,2017,28,60,62,2049,2051,25.193290654113216,82.89080385266533,2088.2921140132853,0,0.0
885,1993,2017,24,62,66,2055,2059,47.86691689868826,98.97595470140993,4737.673798660723,0,0.0
886,1996,2017,21,63,64,2059,2060,67.00839545281204,111.39830899459781,7464.6219418845585,0,0.0
887,1989,2017,28,63,64,2052,2053,33.5554117729386,90.57701942151144,3039.3491838542727,0,0.0
888,1989,2017,28,67,63,2056,2052,36.055745415772826,101.94523334245224,0.0,0,0.0
889,1993,2017,24,66,63,2059,2056,47.279741545072355,111.39830899459781,0.0,0,0.0
890,1993,2017,24,60,63,2053,2056,41.638486903294535,93.29433000415678,3884.63473802972,0,0.0
891,1998,2017,19,60,61,2058,2059,60.45704970323946,108.15369805300759,6538.653498779833,0,0.0
892,1998,2017,19,63,67,2061,2065,99.77805962022678,118.18246601236882,11792.017139847561,0,0.0
893,1992,2017,25,63,66,2055,2058,44.47973162516256,98.97595470140993,4402.42390246296,0,0.0
894,1994,2017,23,63,64,2057,2058,54.51732923613136,105.0035903427258,5724.515305690245,0,0.0
895,1989,2017,28,67,66,2056,2055,46.110964204735794,101.94523334245224,0.0,0,0.0
896,1997,2018,21,66,62,2063,2059,61.207424730750475,125.37977819252208,0.0,0,0.0
897,1991,2018,27,65,62,2056,2053,31.644099466686058,101.94523334245224,0.0,0,0.0
898,1996,2018,22,62,67,2058,2063,52.659795819541664,108.15369805300759,5695.351656599741,0,0.0
899,1996,2018,22,64,62,2060,2058,57.67150869212675,114.74025826443574,0.0,0,0.0
900,1994,2018,24,61,65,2055,2059,41.127601333722374,98.97595470140993,4070.6436065841526,0,0.0
901,1994,2018,24,66,68,2060,2062,69.31385493792851,114.74025826443574,7953.089616881552,0,0.0
902,1994,2018,24,64,69,2058,2063,52.581324284687284,108.15369805300759,5686.864669913343,0,0.0
903,1992,2018,26,60,69,2052,2061,31.557628107765332,90.57701942151144,2858.3958940138955,0,0.0
904,1996,2018,22,66,64,2062,2060,68.31245487099206,121.72793999273989,0.0,0,0.0
905,1992,2018,26,63,66,2055,2058,44.47811795259586,98.97595470140993,4402.264187680095,0,0.0
906,1997,2018,21,67,70,2064,2067,107.19913513648387,129.14117153829775,13843.821899417826,0,0.0
907,1998,2018,20,63,61,2061,2059,64.7105888434845,118.18246601236882,0.0,0,0.0
908,1996,2018,22,62,61,2058,2057,52.921385406822004,108.15369805300759,0.0,0,0.0
909,1991,2018,27,60,60,2051,2051,26.959170462808576,87.93885380729265,2370.7585500948053,0,0.0
910,1995,2019,24,66,66,2061,2061,74.83712470379538,118.18246601236882,8844.435946769705,0,0.0
911,1992,2019,27,65,67,2057,2059,44.89043536550942,105.0035903427258,4713.6568854265615,0,0.0
912,1995,2019,24,62,69,2057,2064,43.0087888312262,105.0035903427258,4516.077243570877,0,0.0
913,2000,2019,19,67,66,2067,2066,130.58871558600956,141.11604495152952,0.0,0,0.0
914,1991,2019,28,65,60,2056,2051,24.6168941255687,101.94523334245224,0.0,0,0.0
915,1995,2019,24,62,60,2057,2055,39.41722031268147,105.0035903427258,0.0,0,0.0
916,1997,2019,22,62,68,2059,2065,53.87615883651902,111.39830899459781,6001.712989512577,0,0.0
917,1993,2019,26,65,62,2058,2055,39.24033352882156,108.15369805300759,0.0,0,0.0
918,1995,2019,24,60,70,2055,2065,35.17771354946116,98.97595470140993,3481.747782770642,0,0.0
919,1995,2019,24,61,65,2056,2060,44.33913193339175,101.94523334245224,4520.163151151397,0,0.0
920,1998,2019,21,65,60,2063,2058,50.12232067558523,125.37977819252208,0.0,0,0.0
921,1998,2019,21,66,62,2064,2060,62.520193787767475,129.14117153829775,0.0,0,0.0
922,1999,2019,20,60,67,2059,2066,53.09189772729373,111.39830899459781,5914.347628134652,0,0.0
923,1993,2019,26,62,61,2055,2054,35.51099019156934,98.97595470140993,0.0,0,0.0
924,1993,2020,27,61,67,2054,2060,27.872864667302974,96.09315990428149,2678.3916414655423,0,0.0
925,1999,2020,21,66,67,2065,2066,107.33703433541285,133.0154066844467,14277.47927442736,0,0.0
926,1997,2020,23,67,61,2064,2058,46.17507656858796,129.14117153829775,0.0,0,0.0
927,1995,2020,25,61,60,2056,2055,33.81862309617631,101.94523334245224,0.0,0,0.0
928,1992,2020,28,65,70,2057,2062,42.22649319442126,105.0035903427258,4433.933392996909,0,0.0
929,1999,2020,21,61,67,2060,2066,53.76561795356735,114.74025826443574,6169.080889739301,0,0.0
930,1996,2020,24,66,70,2062,2066,69.91018824265453,121.72793999273989,8510.023199283,0,0.0
931,1993,2020,27,64,60,2057,2053,30.316430402685313,105.0035903427258,0.0,0,0.0
932,1999,2020,21,65,69,2064,2068,93.9761894820113,129.14117153829775,12136.195206411996,0,0.0
933,1995,2020,25,66,60,2061,2055,37.015585142384936,118.18246601236882,0.0,0,0.0
934,2001,2020,19,66,66,2067,2067,137.9597360876715,141.11604495152952,19468.332319249,0,0.0
935,1999,2020,21,62,60,2061,2059,52.43192271347587,118.18246601236882,0.0,0,0.0
936,1992,2020,28,62,68,2054,2060,29.16701370480704,96.09315990428149,2802.7505118663926,0,0.0
937,1993,2020,27,62,66,2055,2059,37.65552404104587,98.97595470140993,3726.991441744409,0,0.0
938,2002,2021,19,61,66,2063,2068,78.9209717861888,125.37977819252208,9895.093937290645,0,0.0
939,2001,2021,20,62,69,2063,2070,65.1230876262064,125.37977819252208,8165.118281785938,0,0.0
940,1999,2021,22,66,62,2065,2061,52.50801816963491,133.0154066844467,0.0,0,0.0
941,1999,2021,22,65,69,2064,2068,91.57873360056998,129.14117153829775,11826.58494517128,0,0.0
942,1993,2021,28,63,67,2056,2060,35.964844232969504,101.94523334245224,3666.444437455024,0,0.0
943,1994,2021,27,62,68,2056,2062,34.68910263842001,101.94523334245224,3536.388662914004,0,0.0
944,1994,2021,27,66,68,2060,2062,44.312765807967764,114.74025826443574,5084.458193217679,0,0.0
945,1997,2021,24,65,64,2062,2061,56.21285198279656,121.72793999273989,0.0,0,0.0
946,2001,2021,20,62,66,2063,2067,75.68112930137032,125.37977819252208,9488.883205165394,0,0.0
947,1995,2021,26,64,66,2059,2061,47.888241034765585,111.39830899459781,5334.669071998595,0,0.0
948,1993,2021,28,63,70,2056,2063,36.84547509249627,101.94523334245224,3756.2205559180447,0,0.0
949,1994,2021,27,61,61,2055,2055,32.5898684049975,98.97595470140993,3225.613338977944,0,0.0
950,1995,2021,26,64,69,2059,2064,41.00518783733475,111.39830899459781,4567.908585084941,0,0.0
951,1993,2021,28,65,62,2058,2055,30.808574640582087,108.15369805300759,0.0,0,0.0
952,2002,2022,20,65,68,2067,2070,98.49653959395715,141.11604495152952,13899.442108910964,0,0.0
953,2000,2022,22,62,61,2062,2061,48.485176194630995,121.72793999273989,0.0,0,0.0
954,2003,2022,19,64,62,2067,2065,88.76787628810669,141.11604495152952,0.0,0,0.0
955,1998,2022,24,67,61,2065,2059,44.089217615556855,133.0154066844467,0.0,0,0.0
956,2004,2022,18,63,67,2067,2071,103.92577318219264,141.11604495152952,14665.594080000757,0,0.0
957,2003,2022,19,67,64,2070,2067,106.29459692860603,154.20131245175,0.0,0,0.0
958,1997,2022,25,63,67,2060,2064,46.671590277509836,114.74025826443574,5355.110322053407,0,0.0
959,2000,2022,22,60,67,2060,2067,42.903238526824744,114.74025826443574,4922.728668948561,0,0.0
960,1998,2022,24,64,66,2062,2064,58.4919395923802,121.72793999273989,7120.103312760223,0,0.0
961,1999,2022,23,66,65,2065,2064,77.09056025984682,133.0154066844467,0.0,0,0.0
962,2003,2022,19,67,65,2070,2068,112.15813447599271,154.20131245175,0.0,0,0.0
963,2003,2022,19,62,61,2065,2064,65.47549852111102,133.0154066844467,0.0,0,0.0
964,1996,2022,26,61,66,2057,2062,34.3012430924439,105.0035903427258,3601.7536779252323,0,0.0
965,1999,2022,23,63,69,2062,2068,52.75187876877596,121.72793999273989,6421.37753326985,0,0.0
966,2000,2023,23,65,66,2065,2066,69.67747414625336,133.0154066844467,9268.177560308912,0,0.0
967,2005,2023,18,63,64,2068,2069,106.21718298328405,145.3495263000754,15438.617231548767,0,0.0
968,2002,2023,21,64,65,2066,2067,83.43148618514265,137.00586888498012,11430.603257160683,0,0.0
969,2002,2023,21,67,62,2069,2064,60.740146561497106,149.71001208907768,0.0,0,0.0
970,1998,2023,25,61,64,2059,2062,36.88812902896392,111.39830899459781,4109.275195801116,0,0.0
971,2005,2023,18,64,70,2069,2075,111.73632264776099,149.71001208907768,16728.04621438538,0,0.0
972,2003,2023,20,65,68,2068,2071,119.78876541896534,145.3495263000754,17411.24030971747,0,0.0
973,1997,2023,26,65,60,2062,2057,33.838535102958915,121.72793999273989,0.0,0,0.0
974,1995,2023,28,63,69,2058,2064,34.82481140842748,108.15369805300759,3766.4321378199993,0,0.0
975,2003,2023,20,60,60,2063,2063,57.00648196129449,125.37977819252208,7147.460063843115,0,0.0
976,1996,2023,27,60,70,2056,2066,27.890679187059508,101.94523334245224,2843.3217978042576,0,0.0
977,1999,2023,24,62,62,2061,2061,42.75026649471017,118.18246601236882,5052.331917030794,0,0.0
978,2004,2023,19,62,70,2066,2074,75.42105799918814,137.00586888498012,10333.127583403251,0,0.0
979,2002,2023,21,60,69,2062,2071,50.72321292316452,121.72793999273989,6174.432218949939,0,0.0
980,1998,2024,26,67,62,2065,2060,42.341311544625086,133.0154066844467,0.0,0,0.0
981,2001,2024,23,64,65,2065,2066,59.89380797490912,133.0154066844467,7966.799225662694,0,0.0
982,2001,2024,23,66,64,2067,2065,62.07106876300279,141.11604495152952,0.0,0,0.0
983,2002,2024,22,67,61,2069,2063,47.100725071542506,149.71001208907768,0.0,0,0.0
984,2001,2024,23,63,67,2064,2068,52.35756067018365,129.14117153829775,6761.516723835019,0,0.0
985,2000,2024,24,62,63,2062,2063,49.526187334500506,121.72793999273989,6028.7207599232715,0,0.0
986,1997,2024,27,62,63,2059,2060,34.69584635825912,111.39830899459781,3865.0586134464406,0,0.0
987,2001,2024,23,62,60,2063,2061,41.882228963668574,125.37977819252208,0.0,0,0.0
988,1998,2024,26,61,60,2059,2058,31.218228403456756,111.39830899459781,0.0,0,0.0
989,2005,2024,19,64,67,2069,2072,95.80617832102514,149.71001208907768,14343.144114649007,0,0.0
990,2001,2024,23,64,67,2065,2068,58.46912807346429,133.0154066844467,7777.294849176852,0,0.0
991,1998,2024,26,67,69,2065,2067,55.67254621121582,133.0154066844467,7405.306375443524,0,0.0
992,2000,2024,24,61,63,2061,2063,40.1205318256192,118.18246601236882,4741.543388879403,0,0.0
993,1997,2024,27,66,61,2063,2058,28.69334659797421,125.37977819252208,0.0,0,0.0
